team_id,league_id,season,team_name,matches_played_total,matches_played_home,matches_played_away,wins_total,wins_home,wins_away,draws_total,draws_home,draws_away,losses_total,losses_home,losses_away,goals_for_total,goals_for_home,goals_for_away,goals_for_avg_total,goals_for_avg_home,goals_for_avg_away,goals_against_total,goals_against_home,goals_against_away,goals_against_avg_total,goals_against_avg_home,goals_against_avg_away,clean_sheets_total,clean_sheets_home,clean_sheets_away,failed_to_score_total,failed_to_score_home,failed_to_score_away,form,extracted_at
517,135,2024,Venezia,38,19,19,5,5,0,14,5,9,19,9,10,32,17,15,0.8,0.9,0.8,56,22,34,1.5,1.2,1.8,6,4,2,17,9,8,LDLLWLLLDWLLLLDDWLDLDDLLLDDDDLDWDLDWLL,2025-07-27 14:09:22.440109
523,135,2024,Parma,38,19,19,7,5,2,15,6,9,16,8,8,44,25,19,1.2,1.3,1.0,58,28,30,1.5,1.5,1.6,7,3,4,11,4,7,DWLLDLDDDDLWLWLLLWDLDLLLLWLDDDDDWDLLDW,2025-07-27 14:09:22.440194
895,135,2024,Como,38,19,19,13,8,5,10,5,5,15,6,9,49,28,21,1.3,1.5,1.1,52,26,26,1.4,1.4,1.4,7,4,3,8,2,6,LDLDWWLDLLLDLDDWLWDLWLLLWWLDLDWWWWWWDL,2025-07-27 14:09:22.440276
1579,135,2024,Monza,38,19,19,3,1,2,9,5,4,26,13,13,28,13,15,0.7,0.7,0.8,69,31,38,1.8,1.6,2.0,3,1,2,17,8,9,DLDDLLDWDLLLDDLLLLLWLLLLDLLLDLLLLLLWLL,2025-07-27 14:09:22.440343
867,135,2024,Lecce,38,19,19,8,4,4,10,6,4,20,9,11,27,13,14,0.7,0.7,0.7,58,31,27,1.5,1.6,1.4,9,5,4,18,9,9,LLWDDLLLLWLDWDLWLLDWLLWDDLLLLLDLLDLDWW,2025-07-27 14:09:22.440401
487,135,2024,Lazio,38,19,19,18,7,11,11,9,2,9,3,6,61,33,28,1.6,1.7,1.5,49,26,23,1.3,1.4,1.2,9,2,7,6,2,4,WLDWLWWLWWWWWLWLWDLDWLWWDDWDLDWDWDWDDL,2025-07-27 14:09:22.440464
489,135,2024,AC Milan,38,19,19,18,9,9,9,7,2,11,3,8,61,30,31,1.6,1.6,1.6,43,16,27,1.1,0.8,1.4,13,8,5,5,4,1,DLDWWWLWLWDDWLDWDDWLWDWWLLLWWLDWLWWWLW,2025-07-27 14:09:22.440520
490,135,2024,Cagliari,38,19,19,9,6,3,9,4,5,20,9,11,40,24,16,1.1,1.3,0.8,56,28,28,1.5,1.5,1.5,7,4,3,15,7,8,DDLLLWDWLLLDDWLLLLWDWLLWDLLDLWDLLWLLWL,2025-07-27 14:09:22.440585
492,135,2024,Napoli,38,19,19,24,14,10,10,3,7,4,2,2,59,32,27,1.6,1.7,1.4,27,13,14,0.7,0.7,0.7,19,9,10,6,2,4,LWWWDWWWWWLDWWLWWWWWWWDDDLDWDWDWWWWDDW,2025-07-27 14:09:22.440635
494,135,2024,Udinese,38,19,19,12,7,5,8,3,5,18,9,9,41,22,19,1.1,1.2,1.0,56,27,29,1.5,1.4,1.5,9,7,2,12,6,6,DWWWLLWLWLLLDLWLWDDDLLWDWWWDLLLLLDWLLL,2025-07-27 14:09:22.440694
495,135,2024,Genoa,38,19,19,10,5,5,13,7,6,15,7,8,37,21,16,1.0,1.1,0.8,49,25,24,1.3,1.3,1.3,11,5,6,13,5,8,DWLDLLLDLLWDDWDDLWDWLWLDWLDDWLWDLLLDLW,2025-07-27 14:09:22.440762
496,135,2024,Juventus,38,19,19,18,11,7,16,7,9,4,1,3,58,31,27,1.5,1.6,1.4,35,15,20,0.9,0.8,1.1,17,11,6,7,3,4,WWDDDWDWDDWWDDDDWDDDWLWWWWWLLWDWLWDDWW,2025-07-27 14:09:22.440822
497,135,2024,AS Roma,38,19,19,20,13,7,9,2,7,9,4,5,56,37,19,1.5,1.9,1.0,35,15,20,0.9,0.8,1.1,16,8,8,6,2,4,DLDDWWDLLWLLLLWLWDWDWWDWWWWWWWDDWWWLWW,2025-07-27 14:09:22.440890
499,135,2024,Atalanta,38,19,19,22,9,13,8,5,3,8,5,3,78,36,42,2.1,1.9,2.2,37,24,13,1.0,1.3,0.7,15,4,11,7,4,3,WLLWLDWWWWWWWWWWWDDDLWDWDWDWLLLWWDWWWL,2025-07-27 14:09:22.440961
500,135,2024,Bologna,38,19,19,16,10,6,14,7,7,8,2,6,57,33,24,1.5,1.7,1.3,47,18,29,1.2,0.9,1.5,12,7,5,7,1,6,DLDDWDDDWWWLWDWWLDDWDWDWLWWWWWDLWDDLLL,2025-07-27 14:09:22.441021
502,135,2024,Fiorentina,38,19,19,19,12,7,8,4,4,11,3,8,60,32,28,1.6,1.7,1.5,41,18,23,1.1,0.9,1.2,12,7,5,8,4,4,DDDLWDWWWWWWWWLLDLLDWWWLLLWLWWDDWWLLWW,2025-07-27 14:09:22.441074
503,135,2024,Torino,38,19,19,10,6,4,14,7,7,14,6,8,39,17,22,1.0,0.9,1.2,45,18,27,1.2,0.9,1.4,10,6,4,13,7,6,DWWDWLLLWLLLDLDWLDDDDWDDLWWDWDDLWLDLLL,2025-07-27 14:09:22.441152
504,135,2024,Verona,38,19,19,10,4,6,7,5,2,21,10,11,34,15,19,0.9,0.8,1.0,66,36,30,1.7,1.9,1.6,8,5,3,17,10,7,WLWLLLWLLLWLLLLWLWDLLDWLLWLLWDDDLLLDDW,2025-07-27 14:09:22.441228
505,135,2024,Inter,38,19,19,24,13,11,9,4,5,5,2,3,79,40,39,2.1,2.1,2.1,35,21,14,0.9,1.1,0.7,16,6,10,4,1,3,DWWDLWWWDWWDWWWWWWDWWDLWLWDWWWDWLLWWDW,2025-07-27 14:09:22.441309
511,135,2024,Empoli,38,19,19,6,2,4,13,7,6,19,10,9,33,10,23,0.9,0.5,1.2,59,26,33,1.6,1.4,1.7,6,5,1,15,11,4,DWDDWDLLDLWDDLWLLLDLLDLLLLDLLDDLDLLWWL,2025-07-27 14:09:22.441371
