team_id,league_id,season,team_name,matches_played_total,matches_played_home,matches_played_away,wins_total,wins_home,wins_away,draws_total,draws_home,draws_away,losses_total,losses_home,losses_away,goals_for_total,goals_for_home,goals_for_away,goals_for_avg_total,goals_for_avg_home,goals_for_avg_away,goals_against_total,goals_against_home,goals_against_away,goals_against_avg_total,goals_against_avg_home,goals_against_avg_away,clean_sheets_total,clean_sheets_home,clean_sheets_away,failed_to_score_total,failed_to_score_home,failed_to_score_away,form,extracted_at
512,135,2023,Frosinone,38,19,19,8,7,1,11,4,7,19,8,11,44,28,16,1.2,1.5,0.8,69,32,37,1.8,1.7,1.9,7,3,4,12,5,7,LWDWDDLWLLWLWLDLLLLLWDLLLLDLLDDDDWDLWL,2025-07-27 14:09:22.438603
514,135,2023,Salernitana,38,19,19,2,1,1,11,5,6,25,13,12,32,17,15,0.8,0.9,0.8,81,38,43,2.1,2.0,2.3,2,0,2,15,6,9,DDLLDLLLDLLDWLLLDWLLLLDLLLDLLLDLLLLDLD,2025-07-27 14:09:22.438692
1579,135,2023,Monza,38,19,19,11,6,5,12,6,6,15,7,8,39,23,16,1.0,1.2,0.8,51,26,25,1.3,1.4,1.3,12,7,5,14,4,10,LWLDDDWWLDWDDLWLLDWLLWDDWWLWWLLDLDDLLL,2025-07-27 14:09:22.438757
867,135,2023,Lecce,38,19,19,8,6,2,14,6,8,16,7,9,32,17,15,0.8,0.9,0.8,54,27,27,1.4,1.4,1.4,7,4,3,16,8,8,WDWDWLLDDLLDDDDWLLDLLLWLLLDLWDLWWDDLLD,2025-07-27 14:09:22.438816
487,135,2023,Lazio,38,19,19,18,10,8,7,4,3,13,5,8,49,23,26,1.3,1.2,1.4,39,14,25,1.0,0.7,1.3,13,9,4,8,5,3,LLWLDWLWWWLDLWDLWWWWDLWLWLLLWWLWWWDWDD,2025-07-27 14:09:22.438870
488,135,2023,Sassuolo,38,19,19,7,5,2,9,5,4,22,9,13,43,23,20,1.1,1.2,1.1,75,34,41,2.0,1.8,2.2,3,3,0,12,5,7,LLWLWWLDLDLDWLLDLLWLLLDLLLLWLDDDLLWLLD,2025-07-27 14:09:22.438939
489,135,2023,AC Milan,38,19,19,22,12,10,9,4,5,7,3,4,76,38,38,2.0,2.0,2.0,49,17,32,1.3,0.9,1.7,13,8,5,3,2,1,WWWLWWWWLDLDWWLWDWWWWDWWLDWWWWWDLDDWLD,2025-07-27 14:09:22.439003
490,135,2023,Cagliari,38,19,19,8,6,2,12,7,5,18,6,12,42,28,14,1.1,1.5,0.7,68,32,36,1.8,1.7,1.9,5,2,3,11,3,8,DLLDLLLLDWWLDLWLLDDWLLLLDDWWLDWDDLDLWL,2025-07-27 14:09:22.439062
492,135,2023,Napoli,38,19,19,13,6,7,14,7,7,11,6,5,55,24,31,1.4,1.3,1.6,48,27,21,1.3,1.4,1.1,7,3,4,13,6,7,WWLDDWWLWDWLWLLWLDLWDWLDDWWDDLWDLDDLDD,2025-07-27 14:09:22.439123
494,135,2023,Udinese,38,19,19,6,1,5,19,11,8,13,7,6,37,21,16,1.0,1.1,0.8,53,29,24,1.4,1.5,1.3,9,3,6,11,5,6,LDDDLLDDDDWDLDLDDWLDLLDWDLDWLDLLLDDWDW,2025-07-27 14:09:22.439211
495,135,2023,Genoa,38,19,19,12,8,4,13,6,7,13,5,8,45,27,18,1.2,1.4,0.9,45,22,23,1.2,1.2,1.2,9,6,3,10,3,7,LWLDLWDLLWLWLDLDWDDDWWDLDWLLDDWDLWDWLW,2025-07-27 14:09:22.439298
496,135,2023,Juventus,38,19,19,19,11,8,14,7,7,5,1,4,54,26,28,1.4,1.4,1.5,31,11,20,0.8,0.6,1.1,17,10,7,7,3,4,WDWWLWDWWWWWDWWDWWWWWDLLDWLDDLWDDDDDDW,2025-07-27 14:09:22.439379
497,135,2023,AS Roma,38,19,19,18,12,6,9,4,5,11,3,8,65,38,27,1.7,2.0,1.4,46,19,27,1.2,1.0,1.4,11,8,3,5,0,5,DLLWDLWWWLWDWWDLWLDLWWWLWWWDWDWLWDDLWL,2025-07-27 14:09:22.439459
499,135,2023,Atalanta,38,19,19,21,13,8,6,2,4,11,4,7,72,42,30,1.9,2.2,1.6,42,16,26,1.1,0.8,1.4,15,10,5,4,1,3,WLWLWWDLWWLDLLWWLWDWWWWWDLLDWLDWWWWWWL,2025-07-27 14:09:22.439534
500,135,2023,Bologna,38,19,19,18,12,6,14,5,9,6,2,4,54,33,21,1.4,1.7,1.1,32,12,20,0.8,0.6,1.1,17,11,6,10,4,6,LDWDDDWDWDWLWDWWWLDLDWWWWWWLWWDDWDDWDL,2025-07-27 14:09:22.439624
502,135,2023,Fiorentina,38,19,19,17,10,7,9,5,4,12,4,8,61,37,24,1.6,1.9,1.3,46,22,24,1.2,1.2,1.3,8,4,4,10,3,7,WDLWWDWWLLLWLWDWWWLDLLWLDWDDLLDWWLWDWW,2025-07-27 14:09:22.439707
503,135,2023,Torino,38,19,19,13,8,5,14,9,5,11,2,9,36,18,18,0.9,0.9,0.9,36,9,27,0.9,0.5,1.4,18,13,5,17,9,8,DLWWDLDLLWWDLWDWDLWDWDDWLLDDWWLDDLDWWL,2025-07-27 14:09:22.439788
504,135,2023,Verona,38,19,19,9,6,3,11,6,5,18,7,11,38,23,15,1.0,1.2,0.8,51,26,25,1.3,1.4,1.3,8,4,4,11,3,8,WWLDLLDLLLLLDDDLWLLWLDLDDLWWLDLDWLWLWD,2025-07-27 14:09:22.439867
505,135,2023,Inter,38,19,19,29,14,15,7,4,3,2,1,1,89,44,45,2.3,2.3,2.4,22,11,11,0.6,0.6,0.6,21,11,10,1,0,1,WWWWWLWDWWWWDWWWWDWWWWWWWWWWDWWDWWLWDD,2025-07-27 14:09:22.439949
511,135,2023,Empoli,38,19,19,9,5,4,9,5,4,20,9,11,29,15,14,0.8,0.8,0.7,54,23,31,1.4,1.2,1.6,9,6,3,21,11,10,LLLLLWLDWLLWLDDLLDLLWDDWDWLLLLWLWLDLDW,2025-07-27 14:09:22.440030
