team_id,league_id,season,team_name,matches_played_total,matches_played_home,matches_played_away,wins_total,wins_home,wins_away,draws_total,draws_home,draws_away,losses_total,losses_home,losses_away,goals_for_total,goals_for_home,goals_for_away,goals_for_avg_total,goals_for_avg_home,goals_for_avg_away,goals_against_total,goals_against_home,goals_against_away,goals_against_avg_total,goals_against_avg_home,goals_against_avg_away,clean_sheets_total,clean_sheets_home,clean_sheets_away,failed_to_score_total,failed_to_score_home,failed_to_score_away,form,extracted_at
128,71,2020,Santos,38,19,19,14,9,5,12,7,5,12,3,9,52,35,17,1.4,1.8,0.9,51,23,28,1.3,1.2,1.5,7,3,4,9,2,7,DLWWLLDWWDDDWDWLWLWDWLWDLLDWWLLLDDWWDL,2025-07-27 14:09:22.482817
129,71,2020,Ceara,38,19,19,14,7,7,10,5,5,14,7,7,54,22,32,1.4,1.2,1.7,51,25,26,1.3,1.3,1.4,11,4,7,8,5,3,LDLLWWWLLWLDLDWDWDDLDDWWLWDLWLWWLLDLWW,2025-07-27 14:09:22.482898
130,71,2020,Gremio,38,19,19,14,10,4,17,6,11,7,3,4,53,34,19,1.4,1.8,1.0,40,23,17,1.1,1.2,0.9,11,4,7,7,1,6,WDDDDLDWDDLDWLWDWWWWDWWDDWWDDDLLDDWLWL,2025-07-27 14:09:22.482990
131,71,2020,Corinthians,38,19,19,13,8,5,12,7,5,13,4,9,45,29,16,1.2,1.5,0.8,45,23,22,1.2,1.2,1.2,14,7,7,12,5,7,LDWDLWDLLWLDDDLWLWWDLDWDWWWWLWLLWDLLDD,2025-07-27 14:09:22.483051
133,71,2020,Vasco DA Gama,38,19,19,10,7,3,11,5,6,17,7,10,37,21,16,1.0,1.1,0.8,56,21,35,1.5,1.1,1.8,11,7,4,15,6,9,WWWDLDWLWLDLLLLLDLWDDLLDWLDWLLWDDLLLDW,2025-07-27 14:09:22.483109
134,71,2020,Atletico Paranaense,38,19,19,15,9,6,8,5,3,15,5,10,38,20,18,1.0,1.1,0.9,36,13,23,0.9,0.7,1.2,14,7,7,13,6,7,WWLLLLDLDWWLDLLDLLWWWWLLLWWWDDLWWDDWLW,2025-07-27 14:09:22.483190
144,71,2020,Atletico Goianiense,38,19,19,12,6,6,14,9,5,12,4,8,40,24,16,1.1,1.3,0.8,45,21,24,1.2,1.1,1.3,9,4,5,12,5,7,WDLLLDDWWLDDDLWWDLLDDWDLWWLDDLWWWLDLDW,2025-07-27 14:09:22.483269
147,71,2020,Coritiba,38,19,19,7,4,3,10,6,4,21,9,12,31,13,18,0.8,0.7,0.9,54,19,35,1.4,1.0,1.8,9,7,2,15,8,7,LLLLWWDLDLWLDLDWLLWDLLLDLLLLDWDDDLLWLL,2025-07-27 14:09:22.483346
151,71,2020,Goias,38,19,19,9,6,3,10,5,5,19,8,11,41,19,22,1.1,1.0,1.2,63,28,35,1.7,1.5,1.8,10,8,2,11,6,5,LDLWLLDWDLLLLDDLDLLWDLLWDLWWLLLWLWDWDL,2025-07-27 14:09:22.483430
794,71,2020,RB Bragantino,38,19,19,13,10,3,14,5,9,11,4,7,50,34,16,1.3,1.8,0.8,40,19,21,1.1,1.0,1.1,11,6,5,9,3,6,DDLWLLDLDLWDDLLDWWLDWWDDWLLWDWWWLWDDDW,2025-07-27 14:09:22.483513
154,71,2020,Fortaleza EC,38,19,19,10,8,2,11,6,5,17,5,12,34,20,14,0.9,1.1,0.7,44,15,29,1.2,0.8,1.5,13,11,2,18,9,9,LLDWDWLLWDWDDWDWLLLLDWDDLLDLDLWLLWWLLL,2025-07-27 14:09:22.483596
1062,71,2020,Atletico-MG,38,19,19,20,14,6,8,4,4,10,1,9,64,41,23,1.7,2.2,1.2,45,13,32,1.2,0.7,1.7,13,9,4,7,2,5,WWWLLWWLWWWWLWDLDLWWLDWDWLWDWDLWWLDDWW,2025-07-27 14:09:22.483684
118,71,2020,Bahia,38,19,19,12,9,3,8,2,6,18,8,10,48,27,21,1.3,1.4,1.1,59,26,33,1.6,1.4,1.7,7,5,2,11,4,7,WWDLDLDLLLLWLWLDWLWWWLLLLLLLDWLWDLDDWW,2025-07-27 14:09:22.483747
119,71,2020,Internacional,38,19,19,20,12,8,10,5,5,8,2,6,61,34,27,1.6,1.8,1.4,35,17,18,0.9,0.9,0.9,15,8,7,7,1,6,WWLWWWDDWLLDDWWWWDLDLLDDWWWWWWWWWDLWLD,2025-07-27 14:09:22.483804
120,71,2020,Botafogo,38,19,19,5,3,2,12,5,7,21,11,10,32,16,16,0.8,0.8,0.8,62,30,32,1.6,1.6,1.7,5,4,1,14,8,6,DDWDLDDDLDDLDWWLDDLLLLLLLWLLLLLLDLLLWL,2025-07-27 14:09:22.483858
121,71,2020,Palmeiras,38,19,19,15,9,6,13,8,5,10,2,8,51,33,18,1.3,1.7,0.9,37,16,21,1.0,0.8,1.1,12,7,5,7,1,6,DDWWDDWWDDDWLLLLWWWWLWDWLWWDWLLDDWLDDL,2025-07-27 14:09:22.483914
123,71,2020,Sport Recife,38,19,19,12,8,4,6,2,4,20,9,11,31,19,12,0.8,1.0,0.6,50,23,27,1.3,1.2,1.4,10,7,3,19,7,12,WLDLLLWWLDWWWLLLLDWDLLLLWDLWLLLWLWWDLL,2025-07-27 14:09:22.483969
124,71,2020,Fluminense,38,19,19,18,11,7,10,5,5,10,3,7,55,31,24,1.4,1.6,1.3,42,14,28,1.1,0.7,1.5,11,8,3,7,3,4,LDWLWWDLLWLWDWWDDWWLLWDWDLLWLWDWWWDWDW,2025-07-27 14:09:22.484034
126,71,2020,Sao Paulo,38,19,19,18,10,8,12,7,5,8,2,6,59,29,30,1.6,1.5,1.6,41,16,25,1.1,0.8,1.3,10,7,3,5,2,3,WLDWWWLWDDDDWWDWWWDDWWWWLWWLLDLDLDWDLW,2025-07-27 14:09:22.484093
127,71,2020,Flamengo,38,19,19,21,11,10,8,4,4,9,4,5,68,35,33,1.8,1.8,1.7,48,23,25,1.3,1.2,1.3,9,3,6,6,2,4,LLWDDWWWWLDWWWWDWDLLDWWWWDLLWWLWWWDWWL,2025-07-27 14:09:22.484149
