team_id,league_id,season,team_name,matches_played_total,matches_played_home,matches_played_away,wins_total,wins_home,wins_away,draws_total,draws_home,draws_away,losses_total,losses_home,losses_away,goals_for_total,goals_for_home,goals_for_away,goals_for_avg_total,goals_for_avg_home,goals_for_avg_away,goals_against_total,goals_against_home,goals_against_away,goals_against_avg_total,goals_against_avg_home,goals_against_avg_away,clean_sheets_total,clean_sheets_home,clean_sheets_away,failed_to_score_total,failed_to_score_home,failed_to_score_away,form,extracted_at
1063,61,2021,Saint Etienne,40,20,20,7,4,3,13,7,6,20,9,11,44,25,19,1.1,1.3,1.0,79,39,40,2.0,2.0,2.0,4,1,3,9,3,6,DDDLLLLLDLDDWWLLLLLLLWWWDLWDDLLWDLLLLDDD,2025-07-27 14:09:22.450098
77,61,2021,Angers,38,19,19,10,8,2,11,2,9,17,9,8,44,23,21,1.2,1.2,1.1,55,23,32,1.4,1.2,1.7,8,6,2,11,6,5,WWDWDLDDWLDLDWDLWLLDWLLLLLLLWLDDLDLWLW,2025-07-27 14:09:22.450184
78,61,2021,Bordeaux,38,19,19,6,3,3,13,7,6,19,9,10,52,25,27,1.4,1.3,1.4,91,33,58,2.4,1.7,3.1,2,1,1,12,6,6,LDDLLWDDLDDWLDLLDWLLLWLLDDLLLDWLDLLLDW,2025-07-27 14:09:22.450254
79,61,2021,Lille,38,19,19,14,7,7,13,8,5,11,4,7,48,24,24,1.3,1.3,1.3,48,22,26,1.3,1.2,1.4,10,7,3,9,5,4,DLDWLLWWWLDLDDDWWDWDWLLWDWWDWDDLLWLLWD,2025-07-27 14:09:22.450317
80,61,2021,Lyon,38,19,19,17,11,6,11,5,6,10,3,7,66,42,24,1.7,2.2,1.3,51,25,26,1.3,1.3,1.4,9,3,6,5,1,4,DLDWWLWDDWLWLWLDDDDWWWLWDLWLDWDWLWWLWW,2025-07-27 14:09:22.450374
81,61,2021,Marseille,38,19,19,21,9,12,8,5,3,9,5,4,63,33,30,1.7,1.7,1.6,38,22,16,1.0,1.2,0.8,15,6,9,8,5,3,WDWWWDLLWDDWDWWLWDWDWLWWLDLWWWWLWWLWLW,2025-07-27 14:09:22.450461
82,61,2021,Montpellier,38,19,19,12,7,5,7,5,2,19,7,12,49,27,22,1.3,1.4,1.2,61,26,35,1.6,1.4,1.8,10,6,4,12,6,6,LDWLWDDLDWLWWLLWWWWLLWLLWLLDWLLDLLDLLL,2025-07-27 14:09:22.450554
83,61,2021,Nantes,38,19,19,15,11,4,10,4,6,13,4,9,55,33,22,1.4,1.7,1.2,48,20,28,1.3,1.1,1.5,8,5,3,10,5,5,DWLLLWWLWDWLDLDLWWWDLWLWWDWLLWDDLWDWLD,2025-07-27 14:09:22.450645
84,61,2021,Nice,38,19,19,20,10,10,7,4,3,11,5,6,52,27,25,1.4,1.4,1.3,36,21,15,0.9,1.1,0.8,14,5,9,13,5,8,DWWWDLWWLWDWLWLDLWWWWWLLWDWDLDLWLWWWLW,2025-07-27 14:09:22.450706
85,61,2021,Paris Saint Germain,38,19,19,26,16,10,8,3,5,4,0,4,90,49,41,2.4,2.6,2.2,36,12,24,0.9,0.6,1.3,13,9,4,5,1,4,WWWWWWWWLWDWWWWDDWDDWWWWLWLWLWWWWDDDWW,2025-07-27 14:09:22.450763
91,61,2021,Monaco,38,19,19,20,12,8,9,4,5,9,3,6,65,38,27,1.7,2.0,1.4,40,16,24,1.1,0.8,1.3,11,8,3,10,3,7,DLLWLDWWWLWLDDDWWLWDWLWDDLWLWWWWWWWWWD,2025-07-27 14:09:22.450820
93,61,2021,Reims,38,19,19,11,5,6,13,6,7,14,8,6,43,25,18,1.1,1.3,0.9,44,23,21,1.2,1.2,1.1,11,6,5,13,6,7,DDDLWDLWLDLLDDWWLWDDLLWLDWDWDLLDWLWLWL,2025-07-27 14:09:22.450872
94,61,2021,Rennes,38,19,19,20,14,6,6,1,5,12,4,8,82,50,32,2.2,2.6,1.7,40,13,27,1.1,0.7,1.4,14,11,3,5,1,4,DDWLLLWDWWWDWWWLWLLLWLWLWWWWWDWLLWWLWD,2025-07-27 14:09:22.450924
95,61,2021,Strasbourg,38,19,19,17,11,6,12,5,7,9,3,6,60,36,24,1.6,1.9,1.3,43,18,25,1.1,0.9,1.3,14,7,7,7,3,4,LLDWLWWLDWLWDDDWWLWWWLWWDDDWDWDDWLDWWL,2025-07-27 14:09:22.450975
97,61,2021,Lorient,38,19,19,8,6,2,12,6,6,18,7,11,35,20,15,0.9,1.1,0.8,63,22,41,1.7,1.2,2.2,11,6,5,13,6,7,DWLDWDWDDLDLLLLLLLDDLLWDLWLWDLWLWLLLDD,2025-07-27 14:09:22.451032
99,61,2021,Clermont Foot,38,19,19,9,4,5,9,6,3,20,9,11,38,22,16,1.0,1.2,0.8,69,33,36,1.8,1.7,1.9,8,3,5,12,4,8,WWDDLDLLDWLLLLLDLWDLLWWLWDLLLLLDWDLWLL,2025-07-27 14:09:22.451089
106,61,2021,Stade Brestois 29,38,19,19,13,7,6,9,4,5,16,8,8,49,28,21,1.3,1.5,1.1,57,29,28,1.5,1.5,1.5,7,5,2,7,4,3,DDLLDDLLLDDWWWWWWLDLLWLWDLWLLWDLWWWLLL,2025-07-27 14:09:22.451186
108,61,2021,Auxerre,2,1,1,0,0,0,2,1,1,0,0,0,2,1,1,1.0,1.0,1.0,2,1,1,1.0,1.0,1.0,0,0,0,0,0,0,DD,2025-07-27 14:09:22.451285
110,61,2021,Estac Troyes,38,19,19,9,5,4,11,7,4,18,7,11,37,19,18,1.0,1.0,0.9,53,19,34,1.4,1.0,1.8,9,6,3,9,4,5,LLDLWDLDLWWDLLLWLLDLWLDLLDWWDWLDLLWDLD,2025-07-27 14:09:22.451368
112,61,2021,Metz,38,19,19,6,3,3,13,7,6,19,9,10,35,21,14,0.9,1.1,0.7,69,31,38,1.8,1.6,2.0,8,3,5,16,7,9,DLDDLLLWLLLDDDWLLWDLWLDLDDLDLLLDLLDWWL,2025-07-27 14:09:22.451450
116,61,2021,Lens,38,19,19,17,9,8,11,7,4,10,3,7,62,35,27,1.6,1.8,1.4,48,20,28,1.3,1.1,1.5,8,6,2,8,3,5,DDWDWWLWWLWLWLDDDLLWWLLWDWLDWLWWWDDWWD,2025-07-27 14:09:22.451547
