team_id,league_id,season,team_name,matches_played_total,matches_played_home,matches_played_away,wins_total,wins_home,wins_away,draws_total,draws_home,draws_away,losses_total,losses_home,losses_away,goals_for_total,goals_for_home,goals_for_away,goals_for_avg_total,goals_for_avg_home,goals_for_avg_away,goals_against_total,goals_against_home,goals_against_away,goals_against_avg_total,goals_against_avg_home,goals_against_avg_away,clean_sheets_total,clean_sheets_home,clean_sheets_away,failed_to_score_total,failed_to_score_home,failed_to_score_away,form,extracted_at
33,39,2024,Manchester United,38,19,19,11,7,4,9,3,6,18,9,9,44,23,21,1.2,1.2,1.1,54,28,26,1.4,1.5,1.4,10,5,5,15,8,7,WLLWDLDWLDWDWLLWLLLDWLWLLDWDWLDLLDLLLW,2025-07-27 00:43:45.070537
34,39,2024,Newcastle,38,19,19,20,12,8,6,2,4,12,5,7,68,40,28,1.8,2.1,1.5,47,20,27,1.2,1.1,1.4,13,8,5,7,3,4,WDWWLDDLLWWLDDLWWWWWWLWLLWLWWWWWLWDWLL,2025-07-27 00:43:45.070622
35,39,2024,Bournemouth,38,19,19,15,8,7,11,4,7,12,7,5,58,23,35,1.5,1.2,1.8,46,16,30,1.2,0.8,1.6,9,7,2,8,5,3,DDWLLWLWDWLLWWWDWDDWDWWLWLLDLLDWDDWLLW,2025-07-27 00:43:45.070720
36,39,2024,Fulham,38,19,19,15,7,8,9,5,4,14,7,7,54,27,27,1.4,1.4,1.4,54,30,24,1.4,1.6,1.3,5,2,3,7,4,3,LWDDWWLLDWWLDWDDDWDDLWLWWLWLWLWLLWLLWL,2025-07-27 00:43:45.070818
39,39,2024,Wolves,38,19,19,12,6,6,6,3,3,20,10,10,54,27,27,1.4,1.4,1.4,69,32,37,1.8,1.7,1.9,8,5,3,7,3,4,LLDLLLLLDDWWLLLLWWDLLLLWLWLDWWWWWWLLLD,2025-07-27 00:43:45.070906
40,39,2024,Liverpool,38,19,19,25,14,11,9,4,5,4,1,3,86,42,44,2.3,2.2,2.3,41,16,25,1.1,0.8,1.3,14,6,8,1,1,0,WWWLWWWWDWWWWDDWWWDDWWWDWDWWWWLWWWLDLD,2025-07-27 00:43:45.070998
41,39,2024,Southampton,38,19,19,2,1,1,6,3,3,30,15,15,26,13,13,0.7,0.7,0.7,86,47,39,2.3,2.5,2.1,3,2,1,16,8,8,LLLLDLLLLWLLDLLLDLLLLLLWLLLLLDLLDLLDLL,2025-07-27 00:43:45.071062
42,39,2024,Arsenal,38,19,19,20,11,9,14,6,8,4,2,2,69,35,34,1.8,1.8,1.8,34,17,17,0.9,0.9,0.9,13,7,6,5,2,3,WWDWDWWLDLDWWWDDWWWDWDWWWLDDWWDDWDLDWW,2025-07-27 00:43:45.071123
45,39,2024,Everton,38,19,19,11,5,6,15,9,6,12,5,7,42,26,16,1.1,1.4,0.8,44,23,21,1.2,1.2,1.1,12,6,6,15,7,8,LLLLDWDWDLDDLWDDDLLLWWWDWDDDDLDWLLDWWW,2025-07-27 00:43:45.071208
46,39,2024,Leicester,38,19,19,6,4,2,7,3,4,25,12,13,33,15,18,0.9,0.8,0.9,80,34,46,2.1,1.8,2.4,3,3,0,17,9,8,DLLDDLWWLDLLLWDLLLLLLLWLLLLLLLLDLLWDWL,2025-07-27 00:43:45.071302
47,39,2024,Tottenham,38,19,19,11,6,5,5,3,2,22,10,12,64,35,29,1.7,1.8,1.5,65,35,30,1.7,1.8,1.6,6,2,4,9,3,6,DWLLWWLWLWLWDLLWLLDLLLLWWWLDLLWLLLDLLL,2025-07-27 00:43:45.071390
48,39,2024,West Ham,38,19,19,11,5,6,10,5,5,17,9,8,46,23,23,1.2,1.2,1.2,62,34,28,1.6,1.8,1.5,7,2,5,8,6,2,LWLDLDWLWLDWLLWDDWLLWLDLLWWLDLDLDLDWLW,2025-07-27 00:43:45.071486
49,39,2024,Chelsea,38,19,19,20,12,8,9,5,4,9,2,7,64,35,29,1.7,1.8,1.5,43,18,25,1.1,0.9,1.3,11,6,5,7,1,6,LWDWWWDLWDDWWWWWDLLDDWLWLLWWLWDDWWWLWW,2025-07-27 00:43:45.071544
50,39,2024,Manchester City,38,19,19,21,13,8,8,3,5,9,3,6,72,43,29,1.9,2.3,1.5,44,23,21,1.2,1.2,1.1,13,5,8,6,2,4,WWWWDDWWWLLLLWDLLDWWDWWLWLWLDWDWWWWDWW,2025-07-27 00:43:45.071598
51,39,2024,Brighton,38,19,19,16,8,8,13,8,5,9,3,6,66,30,36,1.7,1.6,1.9,59,26,33,1.6,1.4,1.7,8,3,5,5,4,1,WWDDDLWWDLWWDLDLDDDDWWLLWWWWDLLDLWDWWW,2025-07-27 00:43:45.071650
52,39,2024,Crystal Palace,38,19,19,13,6,7,14,7,7,11,6,5,51,24,27,1.3,1.3,1.4,51,26,25,1.3,1.4,1.3,11,4,7,8,5,3,LLDDDLLLWDLDDWDWLDWDWWLWLWWWDWLLDDDWWD,2025-07-27 00:43:45.071715
55,39,2024,Brentford,38,19,19,16,9,7,8,4,4,14,6,8,66,40,26,1.7,2.1,1.4,57,35,22,1.5,1.8,1.2,8,1,7,8,5,3,WLWLLDWLWLWDWLWLLDLWDLWLWWDLWLDDWWWWLD,2025-07-27 00:43:45.071805
57,39,2024,Ipswich,38,19,19,4,1,3,10,4,6,24,14,10,36,14,22,0.9,0.7,1.2,82,44,38,2.2,2.3,2.0,2,1,1,14,8,6,LLDDDDLLLDWDLLLWLLWDLLLLDLLLLWLDLLDLLL,2025-07-27 00:43:45.071883
65,39,2024,Nottingham Forest,38,19,19,19,9,10,8,5,3,11,5,6,58,26,32,1.5,1.4,1.7,46,16,30,1.2,0.8,1.6,13,8,5,8,5,3,DWDWDLDWWWLLWLWWWWWWDWLWLLDWWWLLWLDDWL,2025-07-27 00:43:45.071942
66,39,2024,Aston Villa,38,19,19,19,11,8,9,7,2,10,1,9,58,34,24,1.5,1.8,1.3,51,20,31,1.3,1.1,1.6,9,4,5,7,2,5,WLWWWDDWDLLDLWWLWLDWWDDLDDWLWWWWWLWWWL,2025-07-27 00:43:45.072013
