team_id,league_id,season,team_name,matches_played_total,matches_played_home,matches_played_away,wins_total,wins_home,wins_away,draws_total,draws_home,draws_away,losses_total,losses_home,losses_away,goals_for_total,goals_for_home,goals_for_away,goals_for_avg_total,goals_for_avg_home,goals_for_avg_away,goals_against_total,goals_against_home,goals_against_away,goals_against_avg_total,goals_against_avg_home,goals_against_avg_away,clean_sheets_total,clean_sheets_home,clean_sheets_away,failed_to_score_total,failed_to_score_home,failed_to_score_away,form,extracted_at
157,78,2024,Bayern München,34,17,17,25,14,11,7,2,5,2,1,1,99,53,46,2.9,3.1,2.7,32,16,16,0.9,0.9,0.9,16,9,7,1,0,1,WWWWDDWWWWWDWLWWWWWWWDWWLDWWDWWDWW,2025-07-27 14:09:22.447101
160,78,2024,SC Freiburg,34,17,17,16,9,7,7,3,4,11,5,6,49,32,17,1.4,1.9,1.0,53,26,27,1.6,1.5,1.6,11,4,7,8,3,5,WLWWLWWLDDLWDWLWLLLWWWWDDDLLWWWDWL,2025-07-27 14:09:22.447187
161,78,2024,VfL Wolfsburg,34,17,17,11,3,8,10,7,3,13,7,6,56,27,29,1.6,1.6,1.7,54,30,24,1.6,1.8,1.4,6,2,4,7,3,4,LWLLDWLDDWWWWLLWWLDDDWDWDLLLLDLLDW,2025-07-27 14:09:22.447265
162,78,2024,Werder Bremen,34,17,17,14,5,9,9,6,3,11,6,5,54,21,33,1.6,1.2,1.9,57,26,31,1.7,1.5,1.8,10,6,4,9,6,3,DDWLWLWDLWLDWWWLDLDWLLLLWLWWWWDDDW,2025-07-27 14:09:22.447345
163,78,2024,Borussia Mönchengladbach,34,17,17,13,7,6,6,3,3,15,7,8,55,29,26,1.6,1.7,1.5,57,26,31,1.7,1.5,1.8,7,4,3,6,3,3,LWLLWLWDWDWLDWWLLLWWDWLWLWWDLLLDLL,2025-07-27 14:09:22.447422
164,78,2024,FSV Mainz 05,34,17,17,14,6,8,10,8,2,10,3,7,55,24,31,1.6,1.4,1.8,43,18,25,1.3,1.1,1.5,9,5,4,8,3,5,DDLWLWLDDWWWLWWWLLWLDWWWWDLDLDLDWD,2025-07-27 14:09:22.447501
165,78,2024,Borussia Dortmund,34,17,17,17,11,6,6,3,3,11,3,8,71,44,27,2.1,2.6,1.6,51,19,32,1.5,1.1,1.9,7,5,2,5,1,4,WDWLWLWLWLWDDDWLLLDWLLWWLLWWDWWWWW,2025-07-27 14:09:22.447579
167,78,2024,1899 Hoffenheim,34,17,17,7,4,3,11,5,6,16,8,8,46,25,21,1.4,1.5,1.2,68,36,32,2.0,2.1,1.9,4,1,3,9,4,5,WLLLLDWDLDWLDDLLLWDLLWDWDLDLWLLDDL,2025-07-27 14:09:22.447658
168,78,2024,Bayer Leverkusen,34,17,17,19,10,9,12,4,8,3,3,0,72,36,36,2.1,2.1,2.1,43,22,21,1.3,1.3,1.2,9,5,4,5,4,1,WLWWDDWDDDWWWWWWWWDWDDWWLWWWDDWDLD,2025-07-27 14:09:22.447773
169,78,2024,Eintracht Frankfurt,34,17,17,17,10,7,9,4,5,8,3,5,68,41,27,2.0,2.4,1.6,46,22,24,1.4,1.3,1.4,9,6,3,4,0,4,LWWWWDLDWWWWDLLWWWDDDWLLLWWLWDWDDW,2025-07-27 14:09:22.447846
170,78,2024,FC Augsburg,34,17,17,11,6,5,10,5,5,13,6,7,35,18,17,1.0,1.1,1.0,51,20,31,1.5,1.2,1.8,11,6,5,12,6,6,DLWLLWLWDDLWDLLLWWWDDDWDWWDLWDLLLL,2025-07-27 14:09:22.447911
172,78,2024,VfB Stuttgart,34,17,17,14,7,7,8,2,6,12,8,4,64,35,29,1.9,2.1,1.7,53,27,26,1.6,1.6,1.5,7,3,4,6,2,4,LDWWDDLWDLWDWWLWWWLLWLDLDLLWLDLWWW,2025-07-27 14:09:22.447962
173,78,2024,RB Leipzig,34,17,17,13,8,5,12,6,6,9,3,6,53,33,20,1.6,1.9,1.2,48,23,25,1.4,1.4,1.5,14,6,8,9,2,7,WWDDWWWWLDLLWWLWLDDDWDDLDWLWWDLDDL,2025-07-27 14:09:22.448024
176,78,2024,VfL Bochum,34,17,17,5,3,2,8,4,4,21,10,11,32,16,16,0.9,0.9,0.9,68,33,35,2.0,1.9,2.1,5,3,2,13,6,7,LLLDLLLLLDLLLDWLWDLLDWDLWLLLLLDDLW,2025-07-27 14:09:22.448081
180,78,2024,1. FC Heidenheim,36,18,18,9,3,6,6,3,3,21,12,9,41,15,26,1.1,0.8,1.4,67,35,32,1.9,1.9,1.8,9,4,5,14,10,4,WWLLWLLDLLLLLLLWDLLLLLDLDWWLLLWDWLDW,2025-07-27 14:09:22.448141
182,78,2024,Union Berlin,34,17,17,10,5,5,11,7,4,13,5,8,36,19,17,1.1,1.1,1.0,50,22,28,1.5,1.3,1.6,8,4,4,13,5,8,DWDWLWWDLDLLLDLLLWLDWLLLWDWWDDDDLW,2025-07-27 14:09:22.448204
186,78,2024,FC St. Pauli,34,17,17,8,3,5,8,5,3,18,9,9,28,10,18,0.8,0.6,1.1,41,19,22,1.2,1.1,1.3,9,4,5,17,11,6,LLLDWLLDWLLWLLWLLWWDLLLLDWLDWDDLDL,2025-07-27 14:09:22.448269
191,78,2024,Holstein Kiel,34,17,17,6,4,2,7,2,5,21,11,10,49,24,25,1.4,1.4,1.5,80,41,39,2.4,2.4,2.3,2,1,1,7,6,1,LLLDLDLLWLLLLLWLWLDLDLLWDLLDLDWWLL,2025-07-27 14:09:22.448328
1660,78,2024,SV Elversberg,2,1,1,0,0,0,1,0,1,1,1,0,3,1,2,1.5,1.0,2.0,4,2,2,2.0,2.0,2.0,0,0,0,0,0,0,DL,2025-07-27 14:09:22.448388
