team_id,league_id,season,team_name,matches_played_total,matches_played_home,matches_played_away,wins_total,wins_home,wins_away,draws_total,draws_home,draws_away,losses_total,losses_home,losses_away,goals_for_total,goals_for_home,goals_for_away,goals_for_avg_total,goals_for_avg_home,goals_for_avg_away,goals_against_total,goals_against_home,goals_against_away,goals_against_avg_total,goals_against_avg_home,goals_against_avg_away,clean_sheets_total,clean_sheets_home,clean_sheets_away,failed_to_score_total,failed_to_score_home,failed_to_score_away,form,extracted_at
1607,253,2020,Chicago Fire,23,12,11,5,5,0,8,3,5,10,4,6,33,23,10,1.4,1.9,0.9,39,18,21,1.7,1.5,1.9,4,3,1,5,2,3,LDWLLLWLDLDLWWDLWDDLDDL,2025-07-27 14:09:22.472218
1595,253,2020,Seattle Sounders,27,16,11,14,11,3,6,3,3,7,2,5,52,38,14,1.9,2.4,1.3,33,17,16,1.2,1.1,1.5,7,4,3,4,1,3,WDDLWLWWDLWWLWWWLDDWLDWWWWL,2025-07-27 14:09:22.472299
1596,253,2020,San Jose Earthquakes,26,13,13,9,5,4,7,5,2,10,3,7,44,23,21,1.7,1.8,1.6,60,24,36,2.3,1.8,2.8,7,4,3,5,2,3,DLDWWWLLLDLDDLLWWWLWDLWWLD,2025-07-27 14:09:22.472397
1597,253,2020,FC Dallas,24,12,12,9,7,2,8,4,4,7,1,6,29,21,8,1.2,1.8,0.7,26,9,17,1.1,0.8,1.4,8,5,3,10,3,7,WDLDDWDLWWWLDDLWLDWWWLDL,2025-07-27 14:09:22.472461
1598,253,2020,Orlando City SC,29,16,13,13,9,4,10,5,5,6,2,4,48,31,17,1.7,1.9,1.3,33,18,15,1.1,1.1,1.2,5,2,3,3,1,2,DLWWDWDWLLWWDDWWWDWDDDLWWWLDL,2025-07-27 14:09:22.472520
1599,253,2020,Philadelphia Union,27,15,12,16,12,4,5,1,4,6,2,4,49,32,17,1.8,2.1,1.4,25,11,14,0.9,0.7,1.2,10,6,4,5,1,4,LDWWDWWLDWWLWWWDWLWWDWWWLWL,2025-07-27 14:09:22.472579
1600,253,2020,Houston Dynamo,23,10,13,4,3,1,9,4,5,10,3,7,30,14,16,1.3,1.4,1.2,40,12,28,1.7,1.2,2.2,3,3,0,5,1,4,DLDLDDWWWDLDLDLWLLDDLLL,2025-07-27 14:09:22.472666
1601,253,2020,Toronto FC,25,14,11,13,7,6,5,3,2,7,4,3,34,17,17,1.4,1.2,1.5,30,12,18,1.2,0.9,1.6,9,5,4,5,4,1,DWDWDLWWWLLWDWWWWWDWLLWLL,2025-07-27 14:09:22.472753
1602,253,2020,New York Red Bulls,24,10,14,9,5,4,5,1,4,10,4,6,31,13,18,1.3,1.3,1.3,34,12,22,1.4,1.2,1.6,5,2,3,6,3,3,WDWLLWLDLLWLWWLLWDDDWLWL,2025-07-27 14:09:22.472818
1603,253,2020,Vancouver Whitecaps,24,11,13,9,6,3,1,0,1,14,5,9,27,21,6,1.1,1.9,0.5,44,20,24,1.8,1.8,1.8,4,1,3,11,2,9,LWLLWDLLLWLWWLLLLWWLWLLW,2025-07-27 14:09:22.472881
1604,253,2020,New York City FC,26,12,14,13,7,6,4,0,4,9,5,4,42,25,17,1.6,2.1,1.2,30,16,14,1.2,1.3,1.0,7,2,5,7,2,5,LLLLWWLLWWWDWDLWWWLDLWWWWD,2025-07-27 14:09:22.472972
1605,253,2020,Los Angeles Galaxy,22,12,10,6,4,2,4,2,2,12,6,6,27,16,11,1.2,1.3,1.1,46,23,23,2.1,1.9,2.3,4,2,2,7,3,4,DLLLDWWWWDLLLLLLWLLWDL,2025-07-27 14:09:22.473058
1606,253,2020,Real Salt Lake,23,13,10,5,4,1,7,4,3,11,5,6,27,14,13,1.2,1.1,1.3,40,18,22,1.7,1.4,2.2,7,5,2,9,5,4,DDWDLLWDDLWLLWDLLLWDLLL,2025-07-27 14:09:22.473127
2242,253,2020,FC Cincinnati,24,11,13,4,2,2,5,4,1,15,5,10,13,5,8,0.5,0.5,0.6,37,10,27,1.5,0.9,2.1,7,5,2,14,8,6,LLLWWDDLDDLLWDLLLLWLLLLL,2025-07-27 14:09:22.473191
1608,253,2020,Atlanta United FC,23,13,10,6,4,2,4,2,2,13,7,6,23,10,13,1.0,0.8,1.3,30,12,18,1.3,0.9,1.8,6,5,1,8,6,2,WWLLLWLDDLLLWLWDLDLLLWL,2025-07-27 14:09:22.473243
1609,253,2020,New England Revolution,28,11,17,11,3,8,8,5,3,9,3,6,33,12,21,1.2,1.1,1.2,29,12,17,1.0,1.1,1.0,7,3,4,10,5,5,LDWDDLDWDLWLDWWDLWWLDLWLWWWL,2025-07-27 14:09:22.473324
1610,253,2020,Colorado Rapids,19,7,12,8,3,5,4,3,1,7,1,6,32,15,17,1.7,2.1,1.4,31,10,21,1.6,1.4,1.8,4,1,3,3,0,3,WWLLDLDDDWLWWLLWWWL,2025-07-27 14:09:22.473410
1611,253,2020,Sporting Kansas City,25,14,11,12,6,6,5,3,2,8,5,3,42,25,17,1.7,1.8,1.5,34,22,12,1.4,1.6,1.1,8,5,3,3,2,1,WWLWWDLWLDDLWLLWWWLDWWWDL,2025-07-27 14:09:22.473470
1612,253,2020,Minnesota United FC,27,10,17,12,6,6,8,3,5,7,1,6,50,22,28,1.9,2.2,1.6,34,9,25,1.3,0.9,1.5,9,5,4,5,1,4,WWWDDDWLLLLWWLDLDWDDWWDWWWL,2025-07-27 14:09:22.473522
1613,253,2020,Columbus Crew,28,16,12,16,14,2,6,1,5,6,1,5,46,32,14,1.6,2.0,1.2,24,9,15,0.9,0.6,1.3,12,9,3,3,0,3,WDWWWDWLDWWDWWLDLLWDLWLWWWWW,2025-07-27 14:09:22.473583
1614,253,2020,CF Montreal,25,13,12,8,4,4,2,1,1,15,8,7,34,16,18,1.4,1.2,1.5,46,21,25,1.8,1.6,2.1,3,2,1,5,4,1,WDLLWLWLWLWLLLLDWLLWLLLWL,2025-07-27 14:09:22.473668
1615,253,2020,DC United,23,12,11,5,2,3,6,4,2,12,6,6,25,12,13,1.1,1.0,1.2,41,21,20,1.8,1.8,1.8,4,2,2,7,4,3,LWDDLDLLWDLDLLLLLDWWWLL,2025-07-27 14:09:22.473800
1616,253,2020,Los Angeles FC,25,14,11,10,8,2,6,4,2,9,2,7,53,39,14,2.1,2.8,1.3,44,20,24,1.8,1.4,2.2,3,3,0,4,1,3,WDDWDWDLLWLLWLWLWWLDWWLDL,2025-07-27 14:09:22.473896
1617,253,2020,Portland Timbers,28,15,13,14,7,7,8,4,4,6,4,2,55,25,30,2.0,1.7,2.3,40,21,19,1.4,1.4,1.5,5,4,1,2,2,0,LWWWDDWWWLDLWLDWWWWWLDDWWLDD,2025-07-27 14:09:22.473985
9568,253,2020,Inter Miami,24,10,14,7,5,2,3,2,1,14,3,11,25,14,11,1.0,1.4,0.8,38,14,24,1.6,1.4,1.7,3,2,1,7,2,5,LLLLLWLDDWLWLLLWWDLWLLWL,2025-07-27 14:09:22.474066
9569,253,2020,Nashville SC,26,12,14,10,5,5,8,5,3,8,2,6,28,17,11,1.1,1.4,0.8,24,9,15,0.9,0.8,1.1,11,5,6,9,2,7,LLWDLLWDDWLWDDDLWWDWDLWWWL,2025-07-27 14:09:22.474158
