team_id,league_id,season,team_name,matches_played_total,matches_played_home,matches_played_away,wins_total,wins_home,wins_away,draws_total,draws_home,draws_away,losses_total,losses_home,losses_away,goals_for_total,goals_for_home,goals_for_away,goals_for_avg_total,goals_for_avg_home,goals_for_avg_away,goals_against_total,goals_against_home,goals_against_away,goals_against_avg_total,goals_against_avg_home,goals_against_avg_away,clean_sheets_total,clean_sheets_home,clean_sheets_away,failed_to_score_total,failed_to_score_home,failed_to_score_away,form,extracted_at
514,135,2021,Salernitana,38,19,19,7,3,4,10,6,4,21,10,11,33,17,16,0.9,0.9,0.8,78,39,39,2.1,2.1,2.1,2,1,1,16,9,7,LLLLDLWLLWLLLDLLLLWLLDDDDLDLLLWWWDWDDL,2025-07-27 14:09:22.435553
515,135,2021,Spezia,38,19,19,10,5,5,6,3,3,22,11,11,41,21,20,1.1,1.1,1.1,71,30,41,1.9,1.6,2.2,7,4,3,10,4,6,DLLWLLLWLDLWLLLDLDWLWWWDLLLLWLWDLLLLWL,2025-07-27 14:09:22.435630
517,135,2021,Venezia,38,19,19,6,3,3,9,5,4,23,11,12,34,21,13,0.9,1.1,0.7,69,38,31,1.8,2.0,1.6,4,2,2,13,5,8,LLWLLDDWLLDWWLLLDDLLDLLWDLLLLLLLLLLWDD,2025-07-27 14:09:22.435715
487,135,2021,Lazio,38,19,19,18,10,8,10,6,4,10,3,7,77,42,35,2.0,2.2,1.8,58,25,33,1.5,1.3,1.7,9,6,3,6,2,4,WWLDDWLWLWDWLLDWLWWDLWDWWDLWWLWWDLWWDD,2025-07-27 14:09:22.435794
488,135,2021,Sassuolo,38,19,19,13,6,7,11,6,5,14,7,7,64,27,37,1.7,1.4,1.9,66,30,36,1.7,1.6,1.9,3,2,1,6,4,2,WDLLLWLDWWLLDWDDWDLDWLDLDWWWDWLWLLLDWL,2025-07-27 14:09:22.435871
489,135,2021,AC Milan,38,19,19,26,12,14,8,4,4,4,3,1,69,28,41,1.8,1.5,2.2,31,12,19,0.8,0.6,1.0,18,11,7,4,3,1,WWWDWWWWWWWDLLWWDLWWWLDWWDDWWWDDWWWWWW,2025-07-27 14:09:22.435965
490,135,2021,Cagliari,38,19,19,6,3,3,12,6,6,20,10,10,34,20,14,0.9,1.1,0.7,68,33,35,1.8,1.7,1.8,3,1,2,14,4,10,DLLDLLDWLLLLDDDDLLLWWLDWDDWLLLLLWLLDLD,2025-07-27 14:09:22.436033
492,135,2021,Napoli,38,19,19,24,11,13,7,3,4,7,5,2,74,37,37,1.9,1.9,1.9,31,16,15,0.8,0.8,0.8,16,7,9,4,3,1,WWWWWWWWDWWDLWDLLWLDWWWWDDWLWWWLDLWWWW,2025-07-27 14:09:22.436106
494,135,2021,Udinese,38,19,19,11,6,5,14,7,7,13,6,7,61,31,30,1.6,1.6,1.6,58,29,29,1.5,1.5,1.5,8,3,5,9,4,5,DWWLLLDDDDLWLDDLDWLLDWLDDWDLWWWLDWLDLW,2025-07-27 14:09:22.436187
495,135,2021,Genoa,38,19,19,4,3,1,16,8,8,18,8,10,27,14,13,0.7,0.7,0.7,60,25,35,1.6,1.3,1.8,10,7,3,20,9,11,LLWLDDLDLDDDLDLLLLDDLLDDDDDDDWLLLWLWLL,2025-07-27 14:09:22.436268
496,135,2021,Juventus,38,19,19,20,10,10,10,5,5,8,4,4,57,25,32,1.5,1.3,1.7,37,14,23,1.0,0.7,1.2,13,8,5,5,3,2,DLLDWWWWDLLWWLWWDWWDWWDWDDWWWWLWDWWLDL,2025-07-27 14:09:22.436344
497,135,2021,AS Roma,38,19,19,18,10,8,9,6,3,11,3,8,59,26,33,1.6,1.4,1.7,43,16,27,1.1,0.8,1.4,15,10,5,7,4,3,WWWLWLWLDWLLWWLLWWDLLWWDDDWWDWWWDLDLDW,2025-07-27 14:09:22.436425
498,135,2021,Sampdoria,38,19,19,10,6,4,6,3,3,22,10,12,46,29,17,1.2,1.5,0.9,63,32,31,1.7,1.7,1.6,7,3,4,12,3,9,LDDWLLDLWLLLWWLLWDDLLLLWLWLLLWLLLDWLWL,2025-07-27 14:09:22.436500
499,135,2021,Atalanta,38,19,19,16,4,12,11,8,3,11,7,4,65,31,34,1.7,1.6,1.8,48,29,19,1.3,1.5,1.0,10,5,5,9,4,5,WDLWWDLWDWDWWWWWWLDWDDLDLWLDWLLLWDDWLL,2025-07-27 14:09:22.436575
500,135,2021,Bologna,38,19,19,12,8,4,10,4,6,16,7,9,44,25,19,1.2,1.3,1.0,55,24,31,1.4,1.3,1.6,13,7,6,12,6,6,WDWLDLWDLLWWLWWLLLWLLLDLWDDLLDWDDWDLLW,2025-07-27 14:09:22.436649
502,135,2021,Fiorentina,38,19,19,19,13,6,5,2,3,14,4,10,59,38,21,1.6,2.0,1.1,51,20,31,1.3,1.1,1.6,11,10,1,7,2,5,LWWWLWLLWLWLWLWWWDDLWDLWWLDWDWWWLLLWLW,2025-07-27 14:09:22.436726
503,135,2021,Torino,38,19,19,13,8,5,11,5,6,14,6,8,46,29,17,1.2,1.5,0.9,41,21,20,1.1,1.1,1.1,9,5,4,12,4,8,LLWWDDLLWLWLWLDDWWLWWDLLDLDDLWDDWDWLWL,2025-07-27 14:09:22.436800
504,135,2021,Verona,38,19,19,14,9,5,11,3,8,13,7,6,65,34,31,1.7,1.8,1.6,59,25,34,1.6,1.3,1.8,4,4,0,6,2,4,LLLWDDWLWDWDWLDWLLDWLWWLWDWDLDWLWDWLLD,2025-07-27 14:09:22.436874
505,135,2021,Inter,38,19,19,25,14,11,9,3,6,4,2,2,84,48,36,2.2,2.5,1.9,32,16,16,0.8,0.8,0.8,15,8,7,3,1,2,WWDWWDWLDWWDWWWWWWWWDWLDLDWDDWWWWLWWWW,2025-07-27 14:09:22.436967
511,135,2021,Empoli,38,19,19,10,4,6,11,5,6,17,10,7,50,28,22,1.3,1.5,1.2,70,44,26,1.8,2.3,1.4,7,1,6,9,3,6,LWLLWWLLWLWDLWDWWDLDLDLDDLLDLDLDLWLLDW,2025-07-27 14:09:22.437046
