team_id,league_id,season,team_name,matches_played_total,matches_played_home,matches_played_away,wins_total,wins_home,wins_away,draws_total,draws_home,draws_away,losses_total,losses_home,losses_away,goals_for_total,goals_for_home,goals_for_away,goals_for_avg_total,goals_for_avg_home,goals_for_avg_away,goals_against_total,goals_against_home,goals_against_away,goals_against_avg_total,goals_against_avg_home,goals_against_avg_away,clean_sheets_total,clean_sheets_home,clean_sheets_away,failed_to_score_total,failed_to_score_home,failed_to_score_away,form,extracted_at
1063,61,2023,Saint Etienne,2,1,1,1,1,0,1,0,1,0,0,0,4,2,2,2.0,2.0,2.0,3,1,2,1.5,1.0,2.0,0,0,0,0,0,0,WD,2025-07-27 14:09:22.452981
79,61,2023,Lille,34,17,17,16,11,5,11,4,7,7,2,5,52,34,18,1.5,2.0,1.1,34,14,20,1.0,0.8,1.2,15,9,6,4,0,4,DWLWDLWDWWDDWWDDLWDWLWLWDDWWWLWLWD,2025-07-27 14:09:22.453039
80,61,2023,Lyon,34,17,17,16,7,9,5,4,1,13,6,7,49,25,24,1.4,1.5,1.4,55,29,26,1.6,1.7,1.5,10,5,5,7,3,4,LLDLDLLDLDWLLLWWWLLWWWWLWWDWWLWWWW,2025-07-27 14:09:22.453095
81,61,2023,Marseille,34,17,17,13,10,3,11,6,5,10,1,9,52,31,21,1.5,1.8,1.2,41,13,28,1.2,0.8,1.6,7,7,0,10,3,7,WDWDDLLWLDLDWWWWDDDLDLWWWLLLDDWWLW,2025-07-27 14:09:22.453149
82,61,2023,Montpellier,34,17,17,10,3,7,12,9,3,12,5,7,43,20,23,1.3,1.2,1.4,48,23,25,1.4,1.4,1.5,10,7,3,10,5,5,DWLLDDWLWLDLDLDWDLDLLWLDWLWWDWDWLD,2025-07-27 14:09:22.453205
83,61,2023,Nantes,34,17,17,9,3,6,6,3,3,19,11,8,30,17,13,0.9,1.0,0.8,55,30,25,1.6,1.8,1.5,8,3,5,14,7,7,LLDDWWLWWLLLDWLLLLDLWLWLLLWLWLDDLL,2025-07-27 14:09:22.453280
84,61,2023,Nice,34,17,17,15,9,6,10,4,6,9,4,5,40,21,19,1.2,1.2,1.1,29,11,18,0.9,0.6,1.1,17,11,6,9,3,6,DDDWWWDWWWWDWLWLWLWDLLDLLWLDWDWWLD,2025-07-27 14:09:22.453364
85,61,2023,Paris Saint Germain,34,17,17,22,9,13,10,6,4,2,2,0,81,42,39,2.4,2.5,2.3,33,22,11,1.0,1.3,0.6,12,4,8,3,1,2,DDWWLWDWWWWWWWWDWWDWWWDDDWWDWWDLWW,2025-07-27 14:09:22.453449
91,61,2023,Monaco,34,17,17,20,10,10,7,3,4,7,4,3,68,30,38,2.0,1.8,2.2,42,14,28,1.2,0.8,1.6,12,8,4,5,3,2,WWDWDLWWWLWDLWWLWLDDWLWDWDWWWWLWWW,2025-07-27 14:09:22.453530
93,61,2023,Reims,34,17,17,13,8,5,8,3,5,13,6,7,42,19,23,1.2,1.1,1.4,47,18,29,1.4,1.1,1.7,8,7,1,6,4,2,LWWDLWWLDWWLLWLLWWDLLDWLDWDDLLLDWW,2025-07-27 14:09:22.453610
94,61,2023,Rennes,34,17,17,12,7,5,10,4,6,12,6,6,53,34,19,1.6,2.0,1.1,46,26,20,1.4,1.5,1.2,7,2,5,8,1,7,WDDDDDWLLDLLWLLDWWWWWWDLDWLLLWLWDL,2025-07-27 14:09:22.453697
95,61,2023,Strasbourg,34,17,17,10,7,3,9,3,6,15,7,8,38,22,16,1.1,1.3,0.9,50,23,27,1.5,1.4,1.6,5,3,2,9,4,5,WLWLDWLLLDDDLDWWWDDLLLLDLWWDWLLLWL,2025-07-27 14:09:22.453778
96,61,2023,Toulouse,34,17,17,11,3,8,10,7,3,13,7,6,42,21,21,1.2,1.2,1.2,46,25,21,1.4,1.5,1.2,6,3,3,10,4,6,WDLDDLWDDLLDLDLDLWLWLWWWLLWDWDWLWL,2025-07-27 14:09:22.453858
97,61,2023,Lorient,34,17,17,7,4,3,8,4,4,19,9,10,43,26,17,1.3,1.5,1.0,66,30,36,1.9,1.8,2.1,4,3,1,14,5,9,DDWLDLLDWLDLLDLLLLDWWWLWLDLLLLLLLW,2025-07-27 14:09:22.453938
99,61,2023,Clermont Foot,34,17,17,5,3,2,10,5,5,19,9,10,26,14,12,0.8,0.8,0.7,60,27,33,1.8,1.6,1.9,5,3,2,16,8,8,LLLDLLDWLDWLDLDLLWDLDLDLLWLDDLWLLL,2025-07-27 14:09:22.454021
106,61,2023,Stade Brestois 29,34,17,17,17,8,9,10,7,3,7,2,5,53,25,28,1.6,1.5,1.6,34,14,20,1.0,0.8,1.2,15,9,6,9,4,5,WWLDWWDDLLLWWDWWWWDDDWWWLDWWLLWDDW,2025-07-27 14:09:22.454103
111,61,2023,Le Havre,34,17,17,7,6,1,11,2,9,16,9,7,34,18,16,1.0,1.1,0.9,45,19,26,1.3,1.1,1.5,7,4,3,16,8,8,DLDWDWLLDDWDDLLWLWDDLLLLWLLDLLDWLL,2025-07-27 14:09:22.454186
112,61,2023,Metz,36,18,18,8,3,5,6,4,2,22,11,11,38,19,19,1.1,1.1,1.1,62,29,33,1.7,1.6,1.8,6,2,4,11,7,4,LDWDWLLLLDDWWLLLLLLLDLLWWLLLWWLLLLLD,2025-07-27 14:09:22.454268
116,61,2023,Lens,34,17,17,14,9,5,9,4,5,11,4,7,45,27,18,1.3,1.6,1.1,37,18,19,1.1,1.1,1.1,14,6,8,7,2,5,LDLLLWWDDWDWWWDWLLWWWDLWWLLDLWLWDD,2025-07-27 14:09:22.454355
