team_id,league_id,season,team_name,matches_played_total,matches_played_home,matches_played_away,wins_total,wins_home,wins_away,draws_total,draws_home,draws_away,losses_total,losses_home,losses_away,goals_for_total,goals_for_home,goals_for_away,goals_for_avg_total,goals_for_avg_home,goals_for_avg_away,goals_against_total,goals_against_home,goals_against_away,goals_against_avg_total,goals_against_avg_home,goals_against_avg_away,clean_sheets_total,clean_sheets_home,clean_sheets_away,failed_to_score_total,failed_to_score_home,failed_to_score_away,form,extracted_at
33,39,2020,Manchester United,38,19,19,21,9,12,11,4,7,6,6,0,73,38,35,1.9,2.0,1.8,44,28,16,1.2,1.5,0.8,13,6,7,8,3,5,LWLWDLWWWWDWWDWWWDWLDWDDWDDWWWWWDWLLDW,2025-07-27 14:09:22.420657
34,39,2020,Newcastle,38,19,19,12,6,6,9,5,4,17,8,9,46,26,20,1.2,1.4,1.1,62,33,29,1.6,1.7,1.5,7,2,5,12,4,8,WLDWLDWLLWWLDLDLLLLLWLWLLDDDLDWWDLWLWW,2025-07-27 14:09:22.420745
36,39,2020,Fulham,38,19,19,5,2,3,13,4,9,20,13,7,27,9,18,0.7,0.5,0.9,53,28,25,1.4,1.5,1.3,9,5,4,18,12,6,LLLLDLWLLWLDDDDDLLDDLDWDWDLWLLLLDLLLDL,2025-07-27 14:09:22.420831
39,39,2020,Wolves,38,19,19,12,7,5,9,4,5,17,8,9,36,21,15,0.9,1.1,0.8,52,25,27,1.4,1.3,1.4,10,5,5,13,4,9,WLLWWDWLDWLLWLDLDLLDLWDWWDLDLLWWLDWLLL,2025-07-27 14:09:22.420899
40,39,2020,Liverpool,38,19,19,20,10,10,9,3,6,9,6,3,68,29,39,1.8,1.5,2.1,42,20,22,1.1,1.1,1.2,12,5,7,8,6,2,WWWLDWWDWDWDWWDDLDLWWLLLLWLLWWWDDWWWWW,2025-07-27 14:09:22.420958
41,39,2020,Southampton,38,19,19,12,8,4,7,3,4,19,8,11,47,28,19,1.2,1.5,1.0,68,25,43,1.8,1.3,2.3,9,6,3,13,4,9,LLWWDWWWDLWWDLDDWLLLLLLDLLWLLWLLDLWWLL,2025-07-27 14:09:22.421013
42,39,2020,Arsenal,38,19,19,18,8,10,7,4,3,13,7,6,55,24,31,1.4,1.3,1.6,39,21,18,1.0,1.1,0.9,12,4,8,12,8,4,WWLWLLWLDLLLDLWWWDWWDLLWLWDWDLWDLWWWWW,2025-07-27 14:09:22.421078
44,39,2020,Burnley,38,19,19,10,4,6,9,6,3,19,9,10,33,14,19,0.9,0.7,1.0,55,27,28,1.4,1.4,1.5,11,3,8,17,8,9,LLLDLLDWLDWDWLWLLWWLLDWDDLDDWLLLWLWLLL,2025-07-27 14:09:22.421138
45,39,2020,Everton,38,19,19,17,6,11,8,4,4,13,9,4,47,24,23,1.2,1.3,1.2,48,28,20,1.3,1.5,1.1,12,3,9,10,5,5,WWWWDLLLWLDWWWWLWDLWDLLWWWLLDDDWLWDLWL,2025-07-27 14:09:22.421194
46,39,2020,Leicester,38,19,19,20,9,11,6,1,5,12,9,3,68,34,34,1.8,1.8,1.8,50,30,20,1.3,1.6,1.1,11,6,5,6,4,2,WWWLLWWWLLWWLWDDWWWDLWDWWLDWWLLWWDLWLL,2025-07-27 14:09:22.421253
47,39,2020,Tottenham,38,19,19,18,10,8,8,3,5,12,6,6,68,35,33,1.8,1.8,1.7,45,20,25,1.2,1.1,1.3,12,7,5,6,3,3,LWDWDWWWWDWDLLDWDWLLLWLLWWWLWDLDWWLWLW,2025-07-27 14:09:22.421329
48,39,2020,West Ham,38,19,19,19,10,9,8,4,4,11,5,6,62,32,30,1.6,1.7,1.6,47,22,25,1.2,1.2,1.3,11,6,5,7,3,4,LLWWDDLWWWLWDLDDWWWWLWDWWLWLDWWLLWLDWW,2025-07-27 14:09:22.421416
49,39,2020,Chelsea,38,19,19,19,9,10,10,6,4,9,4,5,58,31,27,1.5,1.6,1.4,36,18,18,0.9,0.9,0.9,18,10,8,10,6,4,WLDWDDWWWDWLLWLDLWLDWWWWDDWWDLWDWWWLWL,2025-07-27 14:09:22.421473
50,39,2020,Manchester City,38,19,19,27,13,14,5,2,3,6,4,2,83,43,40,2.2,2.3,2.1,32,17,15,0.8,0.9,0.8,19,10,9,3,1,2,WLDWDWDLWWDDWWWWWWWWWWWWWWWLWWWLWWLWLW,2025-07-27 14:09:22.421542
51,39,2020,Brighton,38,19,19,9,4,5,14,9,5,15,6,9,40,22,18,1.1,1.2,0.9,46,22,24,1.2,1.2,1.3,12,7,5,12,5,7,LWLLDDLDWDLLDDDLDLWDWWDDLLLWWLDDLWLDWL,2025-07-27 14:09:22.421625
52,39,2020,Crystal Palace,38,19,19,12,6,6,8,5,3,18,8,10,41,20,21,1.1,1.1,1.1,66,32,34,1.7,1.7,1.8,8,6,2,14,6,8,WWLLDWLWLLWDDLLDWDLLWWLLWDDLWDLLLWLWLL,2025-07-27 14:09:22.421699
60,39,2020,West Brom,38,19,19,5,3,2,11,6,5,22,10,12,35,15,20,0.9,0.8,1.1,76,39,37,2.0,2.1,1.9,6,5,1,16,9,7,LLDLDDLLLWLLDLDLLWLLDLLDDWLDLWWLDDLLLL,2025-07-27 14:09:22.421775
62,39,2020,Sheffield Utd,38,19,19,7,5,2,2,1,1,29,13,16,20,12,8,0.5,0.6,0.4,63,27,36,1.7,1.4,1.9,5,4,1,21,9,12,LLLLDLLLLLLLLDLLLWLWLWLLLLWLLLLLWLLWLW,2025-07-27 14:09:22.421837
63,39,2020,Leeds,38,19,19,18,8,10,5,5,0,15,6,9,62,28,34,1.6,1.5,1.8,54,21,33,1.4,1.1,1.7,12,6,6,10,6,4,LWWDLWLLDWLLWLWWLLWWLWLLWLLDWWWDDLWWWW,2025-07-27 14:09:22.421909
66,39,2020,Aston Villa,38,19,19,16,7,9,7,4,3,15,8,7,55,29,26,1.4,1.5,1.4,46,27,19,1.2,1.4,1.0,15,7,8,8,5,3,WWWWLLWLLWDWWDLLWLWLWDLWLDDLWLLDWLDLWW,2025-07-27 14:09:22.421989
33,39,2021,Manchester United,38,19,19,16,10,6,10,5,5,12,4,8,57,32,25,1.5,1.7,1.3,57,22,35,1.5,1.2,1.8,8,5,3,9,5,4,WDWWWLDLLWLLDWWWDWLDWWDDWWDLWDLWLLDWLL,2025-07-27 14:09:22.422066
34,39,2021,Newcastle,38,19,19,13,8,5,10,6,4,15,5,10,44,26,18,1.2,1.4,0.9,62,27,35,1.6,1.4,1.8,8,5,3,9,3,6,LLDLDDLLDLDDLDWLLLDDWWWDWWWLLLWWWWLLWW,2025-07-27 14:09:22.422143
38,39,2021,Watford,38,19,19,6,2,4,5,2,3,27,15,12,34,17,17,0.9,0.9,0.9,77,46,31,2.0,2.4,1.6,4,1,3,18,8,10,WLLLWDLLWLLWLLLLLLDLDLLWLDLLWLLLLLLDLL,2025-07-27 14:09:22.422219
39,39,2021,Wolves,38,19,19,15,7,8,6,3,3,17,9,8,38,20,18,1.0,1.1,0.9,43,25,18,1.1,1.3,0.9,11,4,7,16,9,7,LLLWLWWWDWLWDDLLWDWWWLWWLLLWWLWLLLDLDL,2025-07-27 14:09:22.422293
40,39,2021,Liverpool,38,19,19,28,15,13,8,4,4,2,0,2,94,49,45,2.5,2.6,2.4,26,9,17,0.7,0.5,0.9,21,12,9,1,0,1,WWDWWDDWWDLWWWWWWDLDWWWWWWWWWWDWWWDWWW,2025-07-27 14:09:22.422369
41,39,2021,Southampton,38,19,19,9,6,3,13,7,6,16,6,10,43,23,20,1.1,1.2,1.1,67,24,43,1.8,1.3,2.3,8,6,2,9,3,6,LDDDDLLWDWWLLDDLDWDWLDWDWWLLLDLWLDLLLL,2025-07-27 14:09:22.422450
42,39,2021,Arsenal,38,19,19,22,13,9,3,2,1,13,4,9,61,35,26,1.6,1.8,1.4,48,17,31,1.3,0.9,1.6,13,7,6,11,3,8,LLLWWWDDWWWLWLLWWWWLDWWWWWLWLLLWWWWLLW,2025-07-27 14:09:22.422527
44,39,2021,Burnley,38,19,19,7,5,2,14,6,8,17,8,9,34,18,16,0.9,0.9,0.8,53,25,28,1.4,1.3,1.5,9,6,3,16,8,8,LLDLLDDLDWDDDLDLLDDDLWWDLLLLWLDWWWLLDL,2025-07-27 14:09:22.422604
45,39,2021,Everton,38,19,19,11,9,2,6,2,4,21,8,13,43,27,16,1.1,1.4,0.8,66,25,41,1.7,1.3,2.2,8,6,2,12,5,7,WDWWLWDLLLDLLLWLDLLLLWLLLLWLLWDLWWDLWL,2025-07-27 14:09:22.422677
46,39,2021,Leicester,38,19,19,14,10,4,10,4,6,14,5,9,62,34,28,1.6,1.8,1.5,59,23,36,1.6,1.2,1.9,7,6,1,6,4,2,WLWLLDDWWLDLWDLWLWLDLDLWWLWDWLDDLLWWDW,2025-07-27 14:09:22.422752
47,39,2021,Tottenham,38,19,19,22,13,9,5,1,4,11,5,6,69,38,31,1.8,2.0,1.6,40,19,21,1.1,1.0,1.1,16,8,8,10,4,6,WWWLLLWWLLDWWWDWDWWLLLWLWWLWWWWLDWDWWW,2025-07-27 14:09:22.422827
48,39,2021,West Ham,38,19,19,16,9,7,8,5,3,14,5,9,60,33,27,1.6,1.7,1.4,51,26,25,1.3,1.4,1.3,8,4,4,8,0,8,WWDDLWLWWWWLLDWDLLWWWLLWDDWLWLWLDLLWDL,2025-07-27 14:09:22.422916
49,39,2021,Chelsea,38,19,19,21,9,12,11,7,4,6,3,3,76,37,39,2.0,1.9,2.1,33,22,11,0.9,1.2,0.6,16,6,10,4,1,3,WWDWWLWWWWDWDWLWDDWDDLDWWWWWLWLWDLDWDW,2025-07-27 14:09:22.422992
50,39,2021,Manchester City,38,19,19,29,15,14,6,2,4,3,2,1,99,58,41,2.6,3.1,2.2,26,15,11,0.7,0.8,0.6,21,11,10,4,2,2,LWWWDWDWWLWWWWWWWWWWWWDWWLWWDWDWWWWWDW,2025-07-27 14:09:22.423071
51,39,2021,Brighton,38,19,19,12,5,7,15,7,8,11,7,4,42,19,23,1.1,1.0,1.2,44,23,21,1.2,1.2,1.1,11,6,5,13,9,4,WWLWWDDDLDDLDDDLWDWDDDWLLLLLLDWWLDWWDW,2025-07-27 14:09:22.423155
52,39,2021,Crystal Palace,38,19,19,11,7,4,15,8,7,12,4,8,50,27,23,1.3,1.4,1.2,46,17,29,1.2,0.9,1.5,12,9,3,11,4,7,LDDWLDDDDWWDLLLWDLWLDLDDLWDWDWLLDWWDLW,2025-07-27 14:09:22.423234
55,39,2021,Brentford,38,19,19,13,7,6,7,3,4,18,9,9,48,22,26,1.3,1.2,1.4,56,21,35,1.5,1.1,1.8,9,7,2,12,6,6,WDDLWDWLLLLDWLDWLLWLLLLLDLLWWLWWWDLWWL,2025-07-27 14:09:22.423314
63,39,2021,Leeds,38,19,19,9,4,5,11,6,5,18,9,9,42,19,23,1.1,1.0,1.2,79,38,41,2.1,2.0,2.2,5,2,3,13,6,7,LDDLDLWLDWDLDWDLLLWWLDLLLLLLWWDWDLLLDW,2025-07-27 14:09:22.423393
66,39,2021,Aston Villa,38,19,19,13,6,7,6,5,1,19,8,11,52,29,23,1.4,1.5,1.2,54,29,25,1.4,1.5,1.3,11,5,6,8,3,5,LWDLWWLLLLLWWLWLWLLDWDLLWWWLLLLDWWLDDL,2025-07-27 14:09:22.423470
71,39,2021,Norwich,38,19,19,5,3,2,7,3,4,26,13,13,23,12,11,0.6,0.6,0.6,84,43,41,2.2,2.3,2.2,6,3,3,22,10,12,LLLLLLDDLLWWDDLLLLLLWWDLLLLLLDWLLLLLDL,2025-07-27 14:09:22.423547
33,39,2022,Manchester United,38,19,19,23,15,8,6,3,3,9,1,8,58,36,22,1.5,1.9,1.2,43,10,33,1.1,0.5,1.7,17,11,6,7,2,5,LLWWWWLWDWDWLWWWWWDLWDWWLDLWWWDWLLWWWW,2025-07-27 14:09:22.423625
34,39,2022,Newcastle,38,19,19,19,11,8,14,6,8,5,2,3,68,36,32,1.8,1.9,1.7,33,14,19,0.9,0.7,1.0,14,9,5,11,5,6,WDDDLDDWWDWWWWWWDDWDDDLLWWWWWLWWWLDWDD,2025-07-27 14:09:22.423703
35,39,2022,Bournemouth,38,19,19,11,6,5,6,4,2,21,9,12,37,20,17,1.0,1.1,0.9,71,28,43,1.9,1.5,2.3,8,5,3,18,8,10,WLLLDWDDWDLLLLWLLLLDLDWLLWLWLWWLWWLLLL,2025-07-27 14:09:22.423780
36,39,2022,Fulham,38,19,19,15,8,7,7,5,2,16,6,10,55,31,24,1.4,1.6,1.3,53,29,24,1.4,1.5,1.3,9,3,6,9,4,5,DDWLWLWLLDWWDLLWWWWLLDWWDLLLLWWLLLWWDL,2025-07-27 14:09:22.423857
39,39,2022,Wolves,38,19,19,11,9,2,8,3,5,19,7,12,31,19,12,0.8,1.0,0.6,58,20,38,1.5,1.1,2.0,11,10,1,15,6,9,LDLDDWLLLWLLDLLWLDWLWWLDLWLLDWWLWLWLDL,2025-07-27 14:09:22.423934
40,39,2022,Liverpool,38,19,19,19,13,6,10,5,5,9,1,8,75,46,29,2.0,2.4,1.5,47,17,30,1.2,0.9,1.6,14,9,5,8,1,7,DDLWWDDLWWLLWWWWLLDLWWDWWLLDDWWWWWWWDD,2025-07-27 14:09:22.424011
41,39,2022,Southampton,38,19,19,6,2,4,7,5,2,25,12,13,36,19,17,0.9,1.0,0.9,73,37,36,1.9,1.9,1.9,4,1,3,15,7,8,LDWLWLLLLDWDLLLLLLWLLLWLWDLDLLLDLLLLLD,2025-07-27 14:09:22.424091
42,39,2022,Arsenal,38,19,19,26,14,12,6,3,3,6,2,4,88,53,35,2.3,2.8,1.8,43,25,18,1.1,1.3,0.9,14,4,10,4,2,2,WWWWWLWWWWDWWWWWDWWLDLWWWWWWWDDDLWWLLW,2025-07-27 14:09:22.424167
45,39,2022,Everton,38,19,19,8,6,2,12,3,9,18,10,8,34,16,18,0.9,0.8,0.9,57,27,30,1.5,1.4,1.6,9,7,2,14,5,9,LLDDDDWWLLLWDLLLDLLLWLWLLDWDDLLDLDWLDW,2025-07-27 14:09:22.424243
46,39,2022,Leicester,38,19,19,9,5,4,7,4,3,22,10,12,51,23,28,1.3,1.2,1.5,68,27,41,1.8,1.4,2.2,7,3,4,12,8,4,DLLLLLLWLDWWLWWLLLLDWWLLLLDLLLLWDDLLDW,2025-07-27 14:09:22.424320
47,39,2022,Tottenham,38,19,19,18,12,6,6,1,5,14,6,8,70,37,33,1.8,1.9,1.7,63,25,38,1.7,1.3,2.0,10,6,4,4,2,2,WDWWDWWLWWLLWLWDLWLLWWLWWLWDDWLLDLWLLW,2025-07-27 14:09:22.424396
48,39,2022,West Ham,38,19,19,11,8,3,7,4,3,20,7,13,42,26,16,1.1,1.4,0.8,55,24,31,1.4,1.3,1.6,9,6,3,13,4,9,LLLWDLLWWDLWLLLLLDLWDDLWLDWLWDWLLLWLWL,2025-07-27 14:09:22.424472
49,39,2022,Chelsea,38,19,19,11,6,5,11,7,4,16,6,10,38,20,18,1.0,1.1,0.9,47,19,28,1.2,1.0,1.5,10,6,4,14,7,7,WDLWLWWWWDDLLLWDLLWDDDLLWWDLDLLLLWDLLD,2025-07-27 14:09:22.424549
50,39,2022,Manchester City,38,19,19,28,17,11,5,1,4,5,1,4,94,60,34,2.5,3.2,1.8,33,17,16,0.9,0.9,0.8,13,7,6,3,0,3,WWDWWDWWWLWWWLWDWLWWLWWDWWWWWWWWWWWWDL,2025-07-27 14:09:22.424625
51,39,2022,Brighton,38,19,19,18,10,8,8,4,4,12,5,7,72,37,35,1.9,1.9,1.8,53,21,32,1.4,1.1,1.7,12,9,3,5,4,1,WDWWLWDLLDLWWLWLWWDWDLWDWDWLWLWWLWLWDL,2025-07-27 14:09:22.424702
52,39,2022,Crystal Palace,38,19,19,11,7,4,12,7,5,15,5,10,40,21,19,1.1,1.1,1.0,49,23,26,1.3,1.2,1.4,9,5,4,16,7,9,LDWLDDLWDWLWWLLWLLDDLDDDLLLLWWWDLWLWDD,2025-07-27 14:09:22.424778
55,39,2022,Brentford,38,19,19,15,10,5,14,7,7,9,2,7,58,35,23,1.5,1.8,1.2,46,18,28,1.2,0.9,1.5,12,7,5,9,2,7,DWLDDWLDLWDLDDWDWWWDWDDWLWDDLLLDWWLWWW,2025-07-27 14:09:22.424855
63,39,2022,Leeds,38,19,19,7,5,2,10,7,3,21,7,14,48,26,22,1.3,1.4,1.2,78,37,41,2.1,1.9,2.2,5,4,1,10,4,6,WDWLDLDLLLLWWLLDDLDLDLLWLDWLWLLLDLLDLL,2025-07-27 14:09:22.424935
65,39,2022,Nottingham Forest,38,19,19,9,8,1,11,6,5,18,5,13,38,27,11,1.0,1.4,0.6,68,24,44,1.8,1.3,2.3,8,6,2,12,2,10,LWDLLLLLDLDWLDWLDWWDWLDLDLLDLLLLWLWDWD,2025-07-27 14:09:22.425013
66,39,2022,Aston Villa,38,19,19,18,12,6,7,2,5,13,5,8,51,33,18,1.3,1.7,0.9,46,21,25,1.2,1.1,1.3,12,7,5,8,2,6,LWLLLDWDDLLWLWWLWDWWLLLWWDWWWWWDWLLWDW,2025-07-27 14:09:22.425093
33,39,2023,Manchester United,38,19,19,18,10,8,6,3,3,14,6,8,57,31,26,1.5,1.6,1.4,58,28,30,1.5,1.5,1.6,9,4,5,9,4,5,WLWLLWLWWLWWWLWLDLWLDWWWWLLWDLDDWDLLWW,2025-07-27 14:09:22.425169
34,39,2023,Newcastle,38,19,19,18,12,6,6,4,2,14,3,11,85,49,36,2.2,2.6,1.9,62,22,40,1.6,1.2,2.1,10,8,2,5,0,5,WLLLWWWDWDWLWWLLWLLLLWDWDLWLWDWWLWWDLW,2025-07-27 14:09:22.425238
35,39,2023,Bournemouth,38,19,19,13,7,6,9,6,3,16,6,10,54,27,27,1.4,1.4,1.4,67,28,39,1.8,1.5,2.1,9,5,4,7,5,2,DLLDDLLLLWLWWDWWWWLLDDLDLWDWWWLDLWWLLL,2025-07-27 14:09:22.425306
36,39,2023,Fulham,38,19,19,13,9,4,8,2,6,17,8,9,55,31,24,1.4,1.6,1.3,61,24,37,1.6,1.3,1.9,10,6,4,13,7,6,WLDLWDLWLDLLWLWWLLLWLDDWLWWLWDLLWLDDLW,2025-07-27 14:09:22.425377
39,39,2023,Wolves,38,19,19,13,8,5,7,3,4,18,8,10,50,26,24,1.3,1.4,1.3,65,30,35,1.7,1.6,1.8,5,3,2,9,3,6,LLWLLDWDWDLWLLWDLWWWDLWLWWLWLDLDLLWLLL,2025-07-27 14:09:22.425467
40,39,2023,Liverpool,38,19,19,24,15,9,10,3,7,4,1,3,86,49,37,2.3,2.6,1.9,41,17,24,1.1,0.9,1.3,10,6,4,3,2,1,DWWWWWLDWWDWDWWWDDWWWWLWWWWDWWDLWLDWDW,2025-07-27 14:09:22.425551
42,39,2023,Arsenal,38,19,19,28,15,13,5,2,3,5,2,3,91,48,43,2.4,2.5,2.3,29,16,13,0.8,0.8,0.7,18,7,11,5,2,3,WWDWWDWWDWLWWWWLWDLLWWWWWWWWDWWLWWWWWW,2025-07-27 14:09:22.425633
44,39,2023,Burnley,38,19,19,5,2,3,9,4,5,24,13,11,41,19,22,1.1,1.0,1.2,78,43,35,2.1,2.3,1.8,2,1,1,12,7,5,LLLDLLWLLLLLLWLDLWLLDLDLLLLDWDDLDWDLLL,2025-07-27 14:09:22.425697
45,39,2023,Everton,38,19,19,13,8,5,9,4,5,16,7,9,40,22,18,1.1,1.2,0.9,51,18,33,1.3,0.9,1.7,13,9,4,12,5,7,LLLDLWLWLWDWLWWWWLLLDDDLDDLLLDWLWWWDWL,2025-07-27 14:09:22.425753
47,39,2023,Tottenham,38,19,19,20,13,7,6,0,6,12,6,6,74,38,36,1.9,2.0,1.9,61,27,34,1.6,1.4,1.8,7,2,5,4,1,3,DWWWWDWWWWLLLDLWWWLWDWDWLWWLWDWLLLLWLW,2025-07-27 14:09:22.425806
48,39,2023,West Ham,38,19,19,14,7,7,10,8,2,14,4,10,60,31,29,1.6,1.6,1.5,74,28,46,1.9,1.5,2.4,5,4,1,8,4,4,DWWWLLWDLLLWWDWLWWWDDDLLLWWDDLDWLLDLWL,2025-07-27 14:09:22.425870
49,39,2023,Chelsea,38,19,19,18,11,7,9,4,5,11,4,7,77,44,33,2.0,2.3,1.7,63,26,37,1.7,1.4,1.9,8,6,2,6,3,3,DLWLDLWWDLWDLWLLWLWWWLLWDDWDWDWLDWWWWW,2025-07-27 14:09:22.425923
50,39,2023,Manchester City,38,19,19,28,14,14,7,5,2,3,0,3,96,51,45,2.5,2.7,2.4,34,16,18,0.9,0.8,0.9,13,6,7,3,1,2,WWWWWWLLWWWDDDLWDWWWWWWDWWWDDWWWWWWWWW,2025-07-27 14:09:22.425980
51,39,2023,Brighton,38,19,19,12,8,4,12,6,6,14,5,9,55,30,25,1.4,1.6,1.3,62,27,35,1.6,1.4,1.8,6,3,3,10,4,6,WWLWWWLDLDDDWLWDLDWDDLWLWDLWLDLDLLWDLL,2025-07-27 14:09:22.426034
52,39,2023,Crystal Palace,38,19,19,13,8,5,10,4,6,15,7,8,57,37,20,1.5,1.9,1.1,58,26,32,1.5,1.4,1.7,10,6,4,7,4,3,WLDWLDWDLLWLLDLLDDLWLWLLDWLDDLLWWWDWWW,2025-07-27 14:09:22.426088
55,39,2023,Brentford,38,19,19,10,5,5,9,7,2,19,7,12,56,29,27,1.5,1.5,1.4,65,34,31,1.7,1.8,1.6,7,4,3,8,3,5,DWDDLLDLWWWLLWLLLLLWLLWLLLDLLDDDWWLDWL,2025-07-27 14:09:22.426143
62,39,2023,Sheffield Utd,38,19,19,3,2,1,7,4,3,28,13,15,35,19,16,0.9,1.0,0.8,104,57,47,2.7,3.0,2.5,1,1,0,15,7,8,LLLDLLLLLLWDLLLWLDLLDLLWLLLDDLDLLLLLLL,2025-07-27 14:09:22.426219
65,39,2023,Nottingham Forest,38,19,19,9,5,4,9,5,4,20,9,11,49,27,22,1.3,1.4,1.2,67,30,37,1.8,1.6,1.9,4,2,2,10,4,6,LWLWDLDDDLWLLLLDLLWWLLDLWLLLDDWLDLLWLW,2025-07-27 14:09:22.426303
66,39,2023,Aston Villa,38,19,19,20,12,8,8,4,4,10,3,7,76,48,28,2.0,2.5,1.5,61,28,33,1.6,1.5,1.7,8,4,4,6,1,5,LWWLWWWDWWLWWDWWWDLWDLWLWWWLDWLDWWDLDL,2025-07-27 14:09:22.426384
1359,39,2023,Luton,38,19,19,6,4,2,8,4,4,24,11,13,52,28,24,1.4,1.5,1.3,85,37,48,2.2,1.9,2.5,2,2,0,5,1,4,LLLLDWLLDLDLWLLLWWLDWDLLLLDLDLLWLLLDLL,2025-07-27 14:09:22.426464
529,140,2020,Barcelona,38,19,19,24,11,13,7,5,2,7,3,4,85,44,41,2.2,2.3,2.2,38,20,18,1.0,1.1,0.9,14,6,8,3,1,2,WWDLLDWLWLWWDWDWWWWWWWDWWWWWWLWWLWDDLW,2025-07-27 14:09:22.426543
530,140,2020,Atletico Madrid,38,19,19,26,15,11,8,3,5,4,1,3,67,41,26,1.8,2.2,1.4,25,11,14,0.7,0.6,0.7,18,10,8,7,2,5,WDDWWWWWWWLWWWWWWWWDWDLWDWDWLDWWLWDWWW,2025-07-27 14:09:22.426607
531,140,2020,Athletic Club,38,19,19,11,8,3,13,6,7,14,5,9,46,29,17,1.2,1.5,0.9,42,19,23,1.1,1.0,1.2,9,5,4,12,5,7,LWLLWLWLWDLDLWDLWLWLDWDDWLDDDDDWDWDLLL,2025-07-27 14:09:22.426664
532,140,2020,Valencia,38,19,19,10,8,2,13,7,6,15,4,11,50,34,16,1.3,1.8,0.8,53,23,30,1.4,1.2,1.6,7,3,4,9,3,6,WLDWLLLDWDLDDDLLDWDLWDLWLWLWLDDLDLWLWD,2025-07-27 14:09:22.426748
533,140,2020,Villarreal,38,19,19,15,8,7,13,6,7,10,5,5,60,29,31,1.6,1.5,1.6,44,23,21,1.2,1.2,1.1,10,4,6,7,2,5,DWLWDWDWWDDDDWDLWWDDDDLDLLWWWLWLLWLWWL,2025-07-27 14:09:22.426827
536,140,2020,Sevilla,38,19,19,24,14,10,5,1,4,9,4,5,53,27,26,1.4,1.4,1.4,33,11,22,0.9,0.6,1.2,17,11,6,7,4,3,WWDLLLWWWLWDWWDWLWWWWWWLLWWDWWWWWLDWLW,2025-07-27 14:09:22.426908
538,140,2020,Celta Vigo,38,19,19,14,9,5,11,3,8,13,7,6,55,30,25,1.4,1.6,1.3,57,30,27,1.5,1.6,1.4,9,5,4,10,4,6,DWDLLLDLDLWWWWDWLLLDDDWLDWDLWLDLWWWWWL,2025-07-27 14:09:22.426985
539,140,2020,Levante,38,19,19,9,5,4,14,9,5,15,5,10,46,27,19,1.2,1.4,1.0,57,30,27,1.5,1.6,1.4,4,2,2,11,4,7,LWLLLDDDDDWLWDWLWDDWDLDWDLWLLWLLLLDDLD,2025-07-27 14:09:22.427062
797,140,2020,Elche,38,19,19,8,5,3,12,8,4,18,6,12,34,18,16,0.9,0.9,0.8,55,23,32,1.4,1.2,1.7,7,4,3,13,6,7,LWDWWLDDDDLLDDLLDLLDLWLLWLLDDLLDWLLLWW,2025-07-27 14:09:22.427143
541,140,2020,Real Madrid,38,19,19,25,13,12,9,3,6,4,3,1,67,33,34,1.8,1.7,1.8,28,13,15,0.7,0.7,0.8,17,9,8,5,2,3,DWWWLWWLDLWWWWWDWDWLWWWWDDWWWWDWDWDWWW,2025-07-27 14:09:22.427221
542,140,2020,Alaves,38,19,19,9,6,3,11,6,5,18,7,11,36,21,15,0.9,1.1,0.8,57,25,32,1.5,1.3,1.7,9,5,4,13,5,8,LLDLWLWDDDWDLLWDLLLLDWLLLLDLLDWWDLDWWL,2025-07-27 14:09:22.427295
543,140,2020,Real Betis,38,19,19,17,10,7,10,5,5,11,4,7,50,27,23,1.3,1.4,1.2,50,21,29,1.3,1.1,1.5,13,7,6,9,3,6,WWLLWLLWLLLWDLWLDWWDWLWWWWLWDDDDDDWDWW,2025-07-27 14:09:22.427370
545,140,2020,Eibar,38,19,19,6,2,4,12,7,5,20,10,10,29,12,17,0.8,0.6,0.9,52,21,31,1.4,1.1,1.6,9,6,3,14,10,4,DLLLWDWLDDWDDLLDWLLDLLDLDLLDLLLLLWWDLL,2025-07-27 14:09:22.427445
546,140,2020,Getafe,38,19,19,9,6,3,11,6,5,18,7,11,28,15,13,0.7,0.8,0.7,43,13,30,1.1,0.7,1.6,14,8,6,21,9,12,WDWLWLDLDDLLWDLLWWLDLLLLWLDDDLDLWLLLWD,2025-07-27 14:09:22.427520
548,140,2020,Real Sociedad,38,19,19,17,9,8,11,6,5,10,4,6,59,34,25,1.6,1.8,1.3,38,21,17,1.0,1.1,0.9,14,6,8,6,3,3,DDWLWWWWWWDDDLLLWDLDDWWWDWLLDDLWWLWLWW,2025-07-27 14:09:22.427596
715,140,2020,Granada CF,38,19,19,13,9,4,7,4,3,18,6,12,47,25,22,1.2,1.3,1.2,65,25,40,1.7,1.3,2.1,9,7,2,8,5,3,WWLDWWDLLLDWWLWLLWDLDDLLWLWLLWWLWLLLLD,2025-07-27 14:09:22.427672
720,140,2020,Valladolid,38,19,19,5,3,2,16,7,9,17,9,8,34,19,15,0.9,1.0,0.8,57,30,27,1.5,1.6,1.4,3,0,3,14,5,9,DLDLLDLLWWDLWDLDWLDDLLDLDWDDLLDDDDLLLL,2025-07-27 14:09:22.427747
724,140,2020,Cadiz,38,19,19,11,5,6,11,5,6,16,9,7,36,17,19,0.9,0.9,1.0,58,30,28,1.5,1.6,1.5,10,4,6,13,9,4,LWLWDWDWLLDWLLLDDWDLLLLDLWDLWWDLDWWLLD,2025-07-27 14:09:22.427823
726,140,2020,Huesca,38,19,19,7,5,2,13,7,6,18,7,11,34,17,17,0.9,0.9,0.9,53,21,32,1.4,1.1,1.7,9,7,2,16,9,7,DLDDDDLLDDLDWLDLLLLDWLLWDLLDWWLLLWLWLD,2025-07-27 14:09:22.427898
727,140,2020,Osasuna,38,19,19,11,7,4,11,5,6,16,7,9,37,21,16,1.0,1.1,0.8,48,23,25,1.3,1.2,1.3,11,6,5,15,7,8,WLLWDWLLDLLLLDDDDLDWLWWLWLDDDWWWLLDWLL,2025-07-27 14:09:22.427978
529,140,2021,Barcelona,38,19,19,21,12,9,10,2,8,7,5,2,68,37,31,1.8,1.9,1.6,38,19,19,1.0,1.0,1.0,11,5,6,8,4,4,WDWDDWLWLLDDWWLDWDWDWWDWWWWWWWLWLWWWDL,2025-07-27 14:09:22.428052
530,140,2021,Atletico Madrid,38,19,19,21,12,9,8,5,3,9,2,7,65,33,32,1.7,1.7,1.7,43,16,27,1.1,0.8,1.4,12,9,3,7,3,4,WWDWDWLWDDWDWWLLLLWDWLWLWWWWWWLWDLWWDW,2025-07-27 14:09:22.428126
531,140,2021,Athletic Club,38,19,19,14,10,4,13,4,9,11,5,6,43,29,14,1.1,1.5,0.7,36,18,18,0.9,0.9,0.9,13,6,7,14,4,10,DDWWDLDWWDDLDDLDLWLWDWWLWLWLDWDLWWDLWL,2025-07-27 14:09:22.428200
532,140,2021,Valencia,38,19,19,11,6,5,15,8,7,12,5,7,48,26,22,1.3,1.4,1.2,53,24,29,1.4,1.3,1.5,12,6,6,8,3,5,WDWWLLDDLDLWDDDWWWLLDLDLLWWDWDDLLDDLDW,2025-07-27 14:09:22.428275
533,140,2021,Villarreal,38,19,19,16,10,6,11,6,5,11,3,8,63,40,23,1.7,2.1,1.2,37,18,19,1.0,0.9,1.0,14,9,5,11,2,9,DDDDWDWLLDLWDLLWWWWDLWWDWWLWLLDWWLDWLW,2025-07-27 14:09:22.428349
536,140,2021,Sevilla,38,19,19,18,12,6,16,6,10,4,1,3,53,36,17,1.4,1.9,0.9,30,17,13,0.8,0.9,0.7,17,9,8,7,2,5,WWDDWWLWWDWWDLWWWDWWDDDWDWDDDLWLWDDDDW,2025-07-27 14:09:22.428423
538,140,2021,Celta Vigo,38,19,19,12,7,5,10,4,6,16,8,8,43,26,17,1.1,1.4,0.9,43,23,20,1.1,1.2,1.1,14,6,8,15,5,10,LDLLLWWLLWLDDDWLDWWLWDWDDLWLDLLWLDWLWL,2025-07-27 14:09:22.428497
539,140,2021,Levante,38,19,19,8,5,3,11,7,4,19,7,12,51,28,23,1.3,1.5,1.2,76,30,46,2.0,1.6,2.4,7,6,1,12,6,6,DDLDDLLLDLDLLDLDLLLWLLLWDWLDLWLWLDWLWW,2025-07-27 14:09:22.428571
540,140,2021,Espanyol,38,19,19,10,9,1,12,6,6,16,4,12,40,25,15,1.1,1.3,0.8,53,19,34,1.4,1.0,1.8,10,8,2,10,2,8,DDLLDWLWWDDLWLWLWLWLDLLDDLWDWLWLLLDLDD,2025-07-27 14:09:22.428645
797,140,2021,Elche,38,19,19,11,7,4,9,6,3,18,6,12,40,24,16,1.1,1.3,0.8,52,21,31,1.4,1.1,1.6,8,5,3,12,5,7,DLDWDLLWLDLLDLDWLLDWWDWLWLLWLLLWWDLLLW,2025-07-27 14:09:22.428720
542,140,2021,Alaves,38,19,19,8,7,1,7,4,3,23,8,15,31,17,14,0.8,0.9,0.7,65,21,44,1.7,1.1,2.3,6,5,1,16,7,9,LLLLLWLLWWDWDLLDLLDDLLLWLDDLLLLWLWLWLL,2025-07-27 14:09:22.428795
541,140,2021,Real Madrid,38,19,19,26,13,13,8,5,3,4,1,3,80,44,36,2.1,2.3,1.9,31,13,18,0.8,0.7,0.9,16,11,5,8,5,3,WDWWWWDLWDWWWWWWWDWLWDWDWWWWLWWWWWLWDD,2025-07-27 14:09:22.428871
798,140,2021,Mallorca,38,19,19,10,7,3,9,6,3,19,6,13,36,20,16,0.9,1.1,0.8,63,25,38,1.7,1.3,2.0,9,6,3,15,7,8,DWWLDLLWLDDDDLDWDLLLLWWLLLLLLLWLWLLDWW,2025-07-27 14:09:22.428948
543,140,2021,Real Betis,38,19,19,19,10,9,8,2,6,11,7,4,62,34,28,1.6,1.8,1.5,40,22,18,1.1,1.2,0.9,13,5,8,11,5,6,DDLWDWWLWWWLLWWWWLLDWWLWWLLWDWWDLDLWWD,2025-07-27 14:09:22.429022
546,140,2021,Getafe,38,19,19,8,7,1,15,7,8,15,5,10,33,21,12,0.9,1.1,0.6,41,15,26,1.1,0.8,1.4,14,10,4,18,8,10,LLLLLLLDDLDWLWDDDWWLWDWLDDLDDWLLWDDDDL,2025-07-27 14:09:22.429096
548,140,2021,Real Sociedad,38,19,19,17,10,7,11,5,6,10,4,6,40,16,24,1.1,0.8,1.3,37,9,28,1.0,0.5,1.5,20,14,6,11,6,5,LWWWDWWDWDWDWDLLLLDWDDWLWWLWDWWDLDLWWL,2025-07-27 14:09:22.429171
715,140,2021,Granada CF,38,19,19,8,5,3,14,7,7,16,7,9,44,22,22,1.2,1.2,1.2,61,29,32,1.6,1.5,1.7,8,4,4,13,4,9,DDLLDLLWDDWLLDWDWWDDLLLLLDLLWDLLDDWWLD,2025-07-27 14:09:22.429253
724,140,2021,Cadiz,38,19,19,8,3,5,15,9,6,15,7,8,35,19,16,0.9,1.0,0.8,51,24,27,1.3,1.3,1.4,13,6,7,13,6,7,DDLLWDLDLLDDWLLLDDLLDWLDDDWLWDLWLDWLDW,2025-07-27 14:09:22.429328
727,140,2021,Osasuna,38,19,19,12,5,7,11,7,4,15,7,8,37,17,20,1.0,0.9,1.1,51,26,25,1.3,1.4,1.3,12,7,5,15,6,9,DDWLWLWWWDDLLLDDDLLWLWDWLLWLWLWWLDDDLL,2025-07-27 14:09:22.429403
728,140,2021,Rayo Vallecano,38,19,19,11,8,3,9,5,4,18,6,12,39,26,13,1.0,1.4,0.7,50,22,28,1.3,1.2,1.5,9,6,3,14,5,9,LLWDWWWLWLWDLWDWLWLDLLLLLLDLDDLWWDDLLL,2025-07-27 14:09:22.429477
529,140,2022,Barcelona,38,19,19,28,15,13,4,3,1,6,1,5,70,37,33,1.8,1.9,1.7,20,4,16,0.5,0.2,0.8,26,16,10,4,2,2,DWWWWWWWLWWWWWDWWWWWWWLWWWWDDWLWWWLLWL,2025-07-27 14:09:22.429550
530,140,2022,Atletico Madrid,38,19,19,23,13,10,8,3,5,7,3,4,70,41,29,1.8,2.2,1.5,33,15,18,0.9,0.8,0.9,13,6,7,5,2,3,WLWDWLWWWDWLDLWLDWWDWWDWWWWWWLWWWLWDWD,2025-07-27 14:09:22.429625
531,140,2022,Athletic Club,38,19,19,14,8,6,9,3,6,15,8,7,47,22,25,1.2,1.2,1.3,43,15,28,1.1,0.8,1.5,11,8,3,16,10,6,DWWLWWWDLDLWLWDDLLLWWLLDLWDWWWLDLLWLLD,2025-07-27 14:09:22.429700
532,140,2022,Valencia,38,19,19,11,8,3,9,5,4,18,6,12,42,27,15,1.1,1.4,0.8,45,19,26,1.2,1.0,1.4,7,6,1,12,4,8,WLLWLWDWDDLLDWLLDLLLLLWLWLDLLWWLDWWLDD,2025-07-27 14:09:22.429774
533,140,2022,Villarreal,38,19,19,19,12,7,7,3,4,12,4,8,59,36,23,1.6,1.9,1.2,40,18,22,1.1,0.9,1.2,12,5,7,9,3,6,WWDWLDDLWLWLLWWWDWLLLLWWDWWWLLWWDWWWLD,2025-07-27 14:09:22.429848
536,140,2022,Sevilla,38,19,19,13,7,6,10,5,5,15,7,8,47,24,23,1.2,1.3,1.2,54,25,29,1.4,1.3,1.5,9,4,5,7,5,2,LDLLWDLDWDLLDLDWLWWLWDLLWLWDWWWLWWDDLL,2025-07-27 14:09:22.429938
538,140,2022,Celta Vigo,38,19,19,11,7,4,10,6,4,17,6,11,43,26,17,1.1,1.4,0.9,53,21,32,1.4,1.1,1.7,10,6,4,10,2,8,DLWWLLWLLLDLLDDWDLWWLDWDWWDDLLWLLLLDLW,2025-07-27 14:09:22.430016
540,140,2022,Espanyol,38,19,19,8,4,4,13,7,6,17,8,9,52,27,25,1.4,1.4,1.3,69,35,34,1.8,1.8,1.8,6,4,2,4,3,1,DLLWLLDDWLDDDLDDWWLDLWWLLLLLLDLWLLWDDD,2025-07-27 14:09:22.430102
541,140,2022,Real Madrid,38,19,19,24,13,11,6,5,1,8,1,7,75,44,31,2.0,2.3,1.6,36,16,20,0.9,0.8,1.1,13,6,7,5,1,4,WWWWWWDWWWWDLWWLWDWLWWDDWLWLWWLWLWLWWD,2025-07-27 14:09:22.430177
798,140,2022,Mallorca,38,19,19,14,10,4,8,5,3,16,4,12,37,22,15,1.0,1.2,0.8,43,12,31,1.1,0.6,1.6,13,9,4,13,4,9,DLWDLWLDLLWDWWLWLWLWLWLLDLDDWWLDLWLWLW,2025-07-27 14:09:22.430255
543,140,2022,Real Betis,38,19,19,17,9,8,9,5,4,12,5,7,46,26,20,1.2,1.4,1.1,41,18,23,1.1,0.9,1.2,13,7,6,13,5,8,WWWLWWLDWDLWDLDWLWLLWWWDDWLLWLDLWWDLWD,2025-07-27 14:09:22.430316
797,140,2022,Elche,38,19,19,5,3,2,10,6,4,23,10,13,30,18,12,0.8,0.9,0.6,67,29,38,1.8,1.5,2.0,4,2,2,16,7,9,LDLLLLLDDLDLLLLLDDLWLLLWDLLLLLLWLWDDWD,2025-07-27 14:09:22.430402
546,140,2022,Getafe,38,19,19,10,7,3,12,6,6,16,6,10,34,21,13,0.9,1.1,0.7,45,20,25,1.2,1.1,1.3,13,7,6,14,6,8,LLDLWWLLDDDWDLWLLLLDDWLWDWDLDLLLWLDWWD,2025-07-27 14:09:22.430493
547,140,2022,Girona,38,19,19,13,10,3,10,3,7,15,6,9,58,35,23,1.5,1.8,1.2,55,26,29,1.4,1.4,1.5,4,2,2,8,3,5,LWLDWLLLDLDDWWDDWLLWLWWLLDWDWLWWWDLDLL,2025-07-27 14:09:22.430579
548,140,2022,Real Sociedad,38,19,19,21,11,10,8,5,3,9,3,6,51,26,25,1.3,1.4,1.3,35,16,19,0.9,0.8,1.0,15,8,7,9,3,6,WLWDLWWWWWLLDWWWWWDLWDLDDWLWLWDWWDWWLW,2025-07-27 14:09:22.430661
720,140,2022,Valladolid,38,19,19,11,8,3,7,4,3,20,7,13,33,21,12,0.9,1.1,0.6,63,25,38,1.7,1.3,2.0,9,7,2,18,8,10,LDLWLLWDLWWLWLLLLLWWDLLWDLLDWWLLLLLWDD,2025-07-27 14:09:22.430716
723,140,2022,Almeria,38,19,19,11,10,1,8,3,5,19,6,13,49,29,20,1.3,1.5,1.1,65,22,43,1.7,1.2,2.3,4,4,0,10,4,6,LDWLLLLWLWLWLWDLDDWLLLWLLDDWLLWLWLWLDD,2025-07-27 14:09:22.430766
724,140,2022,Cadiz,38,19,19,10,7,3,12,6,6,16,6,10,30,19,11,0.8,1.0,0.6,53,23,30,1.4,1.2,1.6,13,7,6,17,8,9,LLLLLWDDDDLWDLDWDLWLWLWDDDLWLDLWLLWLWD,2025-07-27 14:09:22.430817
727,140,2022,Osasuna,38,19,19,15,11,4,8,1,7,15,7,8,37,24,13,1.0,1.3,0.7,42,21,21,1.1,1.1,1.1,11,6,5,15,6,9,WWLWWLDLLWDWWLLDWDLDDLWDLLDWLWWLLWLWLW,2025-07-27 14:09:22.430867
728,140,2022,Rayo Vallecano,38,19,19,13,9,4,10,5,5,15,5,10,45,28,17,1.2,1.5,0.9,53,22,31,1.4,1.2,1.6,9,4,5,10,5,5,DWLLWLWLDDWWWDDLWLWWDDLDLDDLWLWLWLLLWL,2025-07-27 14:09:22.430916
529,140,2023,Barcelona,38,19,19,26,15,11,7,1,6,5,3,2,79,43,36,2.1,2.3,1.9,44,21,23,1.2,1.1,1.2,17,11,6,2,0,2,DWWWWWDWDWLWWDWLDWWWLWWDWWDWWWWLWLWWWW,2025-07-27 14:09:22.430966
530,140,2023,Atletico Madrid,38,19,19,24,16,8,4,1,3,10,2,8,70,42,28,1.8,2.2,1.5,43,22,21,1.1,1.2,1.1,13,5,8,8,1,7,WDWLWWWWWWLWWLWLDWLWWWDLWDWLLWWLWWWWLW,2025-07-27 14:09:22.431021
531,140,2023,Athletic Club,38,19,19,19,12,7,11,6,5,8,1,7,61,42,19,1.6,2.2,1.0,37,18,19,1.0,0.9,1.0,18,9,9,9,2,7,LWWDWWDLWLDWWDWDWWWWLDWDWLDWWLDDLWDLWW,2025-07-27 14:09:22.431087
532,140,2023,Valencia,38,19,19,13,8,5,10,6,4,15,5,10,40,20,20,1.1,1.1,1.1,45,14,31,1.2,0.7,1.6,13,10,3,13,6,7,WWLLWDLLDWDWLDLLDWWWWLWLDDWLDWWLLLDLLD,2025-07-27 14:09:22.431169
533,140,2023,Villarreal,38,19,19,14,7,7,11,5,6,13,7,6,65,36,29,1.7,1.9,1.5,65,32,33,1.7,1.7,1.7,6,3,3,4,2,2,LWLLWDLDLDWLLWDLLWLLDWDDDWWWWLDWWLWWDD,2025-07-27 14:09:22.431233
534,140,2023,Las Palmas,38,19,19,10,6,4,10,6,4,18,7,11,33,20,13,0.9,1.1,0.7,47,20,27,1.2,1.1,1.4,8,5,3,17,6,11,DLDLLWLWWLWWDLWWDLLWWLDWLDDLLLLLLLLDDD,2025-07-27 14:09:22.431308
536,140,2023,Sevilla,38,19,19,10,6,4,11,5,6,17,8,9,48,27,21,1.3,1.4,1.1,54,27,27,1.4,1.4,1.4,8,3,5,10,3,7,LLLWDWLDDDDDLDLLWLLLLDWWDLWDLWWWDWLLLL,2025-07-27 14:09:22.431394
538,140,2023,Celta Vigo,38,19,19,10,6,4,11,6,5,17,7,10,46,21,25,1.2,1.1,1.3,57,23,34,1.5,1.2,1.8,6,3,3,13,7,6,LDLWLLDLDLLDLDDDWLWDLLWLLDWLWDLWLWLWWD,2025-07-27 14:09:22.431466
541,140,2023,Real Madrid,38,19,19,29,16,13,8,3,5,1,0,1,87,48,39,2.3,2.5,2.1,26,9,17,0.7,0.5,0.9,21,12,9,2,2,0,WWWWWLWWWDWDWWWDWWWWWWDWDWDWWWWWWWWWDD,2025-07-27 14:09:22.431552
542,140,2023,Alaves,38,19,19,12,9,3,10,4,6,16,6,10,36,23,13,0.9,1.2,0.7,46,19,27,1.2,1.0,1.4,11,7,4,15,5,10,LWLWLLDLDDLWLWDLLLDWWWLDDDLWLLLWWWDLWD,2025-07-27 14:09:22.431640
798,140,2023,Mallorca,38,19,19,8,6,2,16,8,8,14,5,9,33,17,16,0.9,0.9,0.8,44,16,28,1.2,0.8,1.5,10,7,3,15,7,8,DLLDWLDDDLDLLDDWDWLDDLLWLDWLWDLLDLWDDW,2025-07-27 14:09:22.431711
543,140,2023,Real Betis,38,19,19,14,9,5,15,7,8,9,3,6,48,27,21,1.3,1.4,1.1,45,19,26,1.2,1.0,1.4,13,7,6,8,3,5,WDLWLDDWDDWWDWDDDDLWLWDWDWLLLLWWDWWDLD,2025-07-27 14:09:22.431770
546,140,2023,Getafe,38,19,19,10,8,2,13,5,8,15,6,9,42,20,22,1.1,1.1,1.2,54,22,32,1.4,1.2,1.7,10,7,3,15,7,8,DLWLWLDDDDDWDWLWWDLLWLDWDLDLWLDDWLLLLL,2025-07-27 14:09:22.431828
547,140,2023,Girona,38,19,19,25,15,10,6,2,4,7,2,5,85,53,32,2.2,2.8,1.7,46,20,26,1.2,1.1,1.4,12,8,4,7,3,4,DWWWWWWLWWWWWDWWWDWDWWDLLWLWLWLWWWDLWW,2025-07-27 14:09:22.431885
548,140,2023,Real Sociedad,38,19,19,16,8,8,12,6,6,10,5,5,51,26,25,1.3,1.4,1.3,39,20,19,1.0,1.1,1.0,15,7,8,10,6,4,DDDWLWWWLWDLWWDWDDDLWDDLWLLWWWDDLWLWWL,2025-07-27 14:09:22.431976
715,140,2023,Granada CF,38,19,19,4,4,0,9,6,3,25,9,16,38,24,14,1.0,1.3,0.7,79,32,47,2.1,1.7,2.5,3,3,0,16,5,11,LLWLLLDDDLLLDLLDLLWLLLDDDLLLLLWDWLLLLL,2025-07-27 14:09:22.432060
723,140,2023,Almeria,38,19,19,3,1,2,12,8,4,23,10,13,43,22,21,1.1,1.2,1.1,75,36,39,2.0,1.9,2.1,6,4,2,12,8,4,LLDLLDLDLLLLLLDLDLLDLLLDDDLDWLDLLWLLDW,2025-07-27 14:09:22.432139
724,140,2023,Cadiz,38,19,19,6,5,1,15,9,6,17,5,12,26,16,10,0.7,0.8,0.5,55,19,36,1.4,1.0,1.9,10,8,2,18,8,10,WLDWLDDLLLDLLDDDDDLLLDDLLDDWLWLLDLWWDL,2025-07-27 14:09:22.432216
727,140,2023,Osasuna,38,19,19,12,6,6,9,5,4,17,8,9,45,19,26,1.2,1.0,1.4,56,26,30,1.5,1.4,1.6,10,6,4,10,6,4,WLWLLDLWLWLLDLDDWLWWDLLWWDWLLWLLLLDDWD,2025-07-27 14:09:22.432293
728,140,2023,Rayo Vallecano,38,19,19,8,4,4,14,8,6,16,7,9,29,18,11,0.8,0.9,0.6,48,26,22,1.3,1.4,1.2,13,4,9,19,7,12,WWLLWDDDDWDDLDLDLLWLDLLLDLDLWDDWLLDWLL,2025-07-27 14:09:22.432369
529,140,2024,Barcelona,38,19,19,28,14,14,4,1,3,6,4,2,102,52,50,2.7,2.7,2.6,39,20,19,1.0,1.1,1.0,13,7,6,2,1,1,WWWWWWWLWWWWLDLWDLLDWWWWWWWWWDWWWWWWLW,2025-07-27 14:09:22.432447
530,140,2024,Atletico Madrid,38,19,19,22,14,8,10,4,6,6,1,5,68,42,26,1.8,2.2,1.4,30,15,15,0.8,0.8,0.8,17,10,7,6,1,5,DWDWWDWDDWLWWWWWWWWLDWDDWWLLDWWLWDWLWW,2025-07-27 14:09:22.432526
531,140,2024,Athletic Club,38,19,19,19,11,8,13,6,7,6,2,4,54,32,22,1.4,1.7,1.2,29,13,16,0.8,0.7,0.8,15,8,7,9,4,5,DLWLWWWDLWDDDWWWWDWWDDWDWLDWDDWLWDWWWL,2025-07-27 14:09:22.432603
532,140,2024,Valencia,38,19,19,11,9,2,13,4,9,14,6,8,44,26,18,1.2,1.4,0.9,54,20,34,1.4,1.1,1.8,8,7,1,10,4,6,LLLDLWDLDLDWLLLDDLDWLWWDLDWDWWWDDWWLLD,2025-07-27 14:09:22.432680
533,140,2024,Villarreal,38,19,19,20,9,11,10,7,3,8,3,5,71,43,28,1.9,2.3,1.5,51,27,24,1.3,1.4,1.3,7,5,2,6,1,5,DWWDWLWWLDWWDDLLDWLWDWWDWLLWDWDLWWWWWW,2025-07-27 14:09:22.432756
534,140,2024,Las Palmas,38,19,19,8,4,4,8,5,3,22,10,12,40,21,19,1.1,1.1,1.0,61,29,32,1.6,1.5,1.7,4,3,1,11,4,7,DLDLLLDLLWWLWLWWDWLLDLLLLDLDDLWWLLLLLL,2025-07-27 14:09:22.432831
536,140,2024,Sevilla,38,19,19,10,6,4,11,6,5,17,7,10,42,17,25,1.1,0.9,1.3,55,23,32,1.4,1.2,1.7,10,5,5,9,4,5,DLDLWLWDWLWLLWDLWLDWDDLWDDWLLLLDLDLWLL,2025-07-27 14:09:22.432908
537,140,2024,Leganes,38,19,19,9,7,2,13,4,9,16,8,8,39,23,16,1.0,1.2,0.8,56,27,29,1.5,1.4,1.5,11,6,5,14,7,7,DWDLLLDDDLWLWLDLWLDWDLLDLWLLLDLDDDWLWW,2025-07-27 14:09:22.433001
538,140,2024,Celta Vigo,38,19,19,16,11,5,7,3,4,15,5,10,59,32,27,1.6,1.7,1.4,57,21,36,1.5,1.1,1.9,8,5,3,4,2,2,WWLLWLLDWLLWDDLWLWLLDLWDWDWWDWLLWLWWLW,2025-07-27 14:09:22.433089
540,140,2024,Espanyol,38,19,19,11,8,3,9,6,3,18,5,13,40,23,17,1.1,1.2,0.9,51,20,31,1.3,1.1,1.6,8,4,4,11,4,7,LLDWWLLLWLLLLWLDDLDWDWLDWDLDWWWDLLLLLW,2025-07-27 14:09:22.433171
541,140,2024,Real Madrid,38,19,19,26,16,10,6,1,5,6,2,4,78,45,33,2.1,2.4,1.7,38,19,19,1.0,1.0,1.0,15,8,7,2,1,1,DWDWWWWDWWLWWWLWDWWWWLDDWLWWWLWWWWLWWW,2025-07-27 14:09:22.433251
798,140,2024,Mallorca,38,19,19,13,7,6,9,6,3,16,6,10,35,20,15,0.9,1.1,0.8,44,21,23,1.2,1.1,1.2,9,5,4,14,5,9,DLDWLWWWLWDLLWWLLWWLLLDWDDDWLLWDLLWLLD,2025-07-27 14:09:22.433331
542,140,2024,Alaves,38,19,19,10,6,4,12,6,6,16,7,9,38,14,24,1.0,0.7,1.3,48,17,31,1.3,0.9,1.6,9,7,2,13,8,5,LDWWLWLLLLLWLLDDDDLWDLLDLDWDLWLDWDLWWD,2025-07-27 14:09:22.433410
543,140,2024,Real Betis,38,19,19,16,9,7,12,7,5,10,3,7,57,32,25,1.5,1.7,1.3,50,21,29,1.3,1.1,1.5,7,5,2,5,0,5,DDLWWLDWLWWDDLLDWDLLWDLWWWWWWDLWWWDDLD,2025-07-27 14:09:22.433487
546,140,2024,Getafe,38,19,19,11,4,7,9,7,2,18,8,10,34,15,19,0.9,0.8,1.0,39,19,20,1.0,1.0,1.1,9,6,3,16,7,9,DDDLLDLWDDDLLWLWLLWDWDWWLLWWLWLLLLLLWL,2025-07-27 14:09:22.433571
547,140,2024,Girona,38,19,19,11,7,4,8,3,5,19,9,10,44,27,17,1.2,1.4,0.9,60,30,30,1.6,1.6,1.6,8,4,4,11,6,5,DLWWLLDDWLLWWWDLLWWLLWLLLDDDLLLLDWLWLL,2025-07-27 14:09:22.433648
548,140,2024,Real Sociedad,38,19,19,13,8,5,7,3,4,18,8,10,35,20,15,0.9,1.1,0.8,46,20,26,1.2,1.1,1.4,13,7,6,19,8,11,LWLDLLDWDWLWWLWWDLWLLLWLWLLDWWLDLDLLWL,2025-07-27 14:09:22.433728
720,140,2024,Valladolid,38,19,19,4,3,1,4,4,0,30,12,18,26,11,15,0.7,0.6,0.8,90,32,58,2.4,1.7,3.1,5,5,0,16,9,7,WLDLLDLLLWLLDLLLWLWLLLLLLDLLLLLLLLLLLL,2025-07-27 14:09:22.433809
727,140,2024,Osasuna,38,19,19,12,10,2,16,6,10,10,3,7,48,33,15,1.3,1.7,0.8,52,23,29,1.4,1.2,1.5,9,5,4,8,0,8,DWLWLWDWDLWWLDDDDLLDDWDDLDLLDDWWWLDWWD,2025-07-27 14:09:22.433886
728,140,2024,Rayo Vallecano,38,19,19,13,6,7,13,8,5,12,5,7,41,24,17,1.1,1.3,0.9,45,26,19,1.2,1.4,1.0,10,4,6,9,3,6,WDLLWDDDWLWLLLWDDDWDWWWLLDLDWLLDLWWDWD,2025-07-27 14:09:22.433967
515,135,2020,Spezia,38,19,19,9,5,4,12,7,5,17,7,10,52,28,24,1.4,1.5,1.3,72,33,39,1.9,1.7,2.1,5,2,3,8,3,5,LWLDDLWDDLLDLLLWWDLLWWLDLDLWLWLDLDLDWD,2025-07-27 14:09:22.434047
523,135,2020,Parma,38,19,19,3,2,1,11,5,6,24,12,12,39,16,23,1.0,0.8,1.2,83,39,44,2.2,2.1,2.3,5,5,0,15,9,6,LLWLDDDLWDDDLLLLLDLLLLDDLDWLDLLLLLLLLL,2025-07-27 14:09:22.434125
487,135,2020,Lazio,38,19,19,21,13,8,5,3,2,12,3,9,61,36,25,1.6,1.9,1.3,55,23,32,1.4,1.2,1.7,12,7,5,6,1,5,WLDLWWDWLWLDWLDWWWWWWLWLLWWWWWLWWLWLDL,2025-07-27 14:09:22.434204
488,135,2020,Sassuolo,38,19,19,17,7,10,11,8,3,10,4,6,64,31,33,1.7,1.6,1.7,56,27,29,1.5,1.4,1.5,8,4,4,4,2,2,DWWWDWDWLDWDLWLWLDLDLWDDLWLDLWWWWDWLWW,2025-07-27 14:09:22.434282
489,135,2020,AC Milan,38,19,19,24,8,16,7,6,1,7,5,2,74,31,43,1.9,1.6,2.3,41,24,17,1.1,1.3,0.9,14,7,7,6,4,2,WWWWDWDWWWDDWWWLWWLWWLLWDWLWDWWLLWWWDW,2025-07-27 14:09:22.434361
490,135,2020,Cagliari,38,19,19,9,5,4,10,4,6,19,10,9,43,22,21,1.1,1.2,1.1,59,32,27,1.6,1.7,1.4,7,3,4,14,7,7,DLLWWLWLDDLDDLLLLLLDLLLWWDLLLLWWWDWDDL,2025-07-27 14:09:22.434441
492,135,2020,Napoli,38,19,19,24,12,12,5,4,1,9,3,6,86,50,36,2.3,2.6,1.9,41,20,21,1.1,1.1,1.1,14,6,8,3,1,2,WWWWLWLWWWLLDWLWWLWLWLWDWWWWLWDWWDWWWD,2025-07-27 14:09:22.434520
494,135,2020,Udinese,38,19,19,10,5,5,10,4,6,18,10,8,42,14,28,1.1,0.7,1.5,58,19,39,1.5,1.0,2.1,8,6,2,12,9,3,LLLWLLDWWWDDLLDLLDDWWLDWDWDLLLWLWLDLLL,2025-07-27 14:09:22.434583
495,135,2020,Genoa,38,19,19,10,5,5,12,7,5,16,7,9,47,29,18,1.2,1.5,0.9,58,30,28,1.5,1.6,1.5,9,3,6,9,1,8,WLDLDLLLLDLDLWDLWDWWWDDLDLDWDLLDWLLWLW,2025-07-27 14:09:22.434635
496,135,2020,Juventus,38,19,19,23,14,9,9,2,7,6,3,3,77,40,37,2.0,2.1,1.9,38,18,20,1.0,0.9,1.1,8,6,2,6,3,3,WDDDWDWDWWDWLWWWLWWWLWDWWWLDWWLWDWLWWW,2025-07-27 14:09:22.434686
497,135,2020,AS Roma,38,19,19,18,13,5,8,4,4,12,2,10,68,42,26,1.8,2.2,1.4,58,18,40,1.5,0.9,2.1,11,9,2,9,2,7,LDWWDWWWLDWWLWWWDLWWLWDLWWLLDWLDLLWLWD,2025-07-27 14:09:22.434761
498,135,2020,Sampdoria,38,19,19,15,9,6,7,3,4,16,7,9,52,32,20,1.4,1.7,1.1,54,26,28,1.4,1.4,1.5,7,4,3,8,3,5,LLWWWDLLDLLWWLLWLWWLDWLLDDLWDLWWLWLDWW,2025-07-27 14:09:22.434841
499,135,2020,Atalanta,38,19,19,23,12,11,9,3,6,6,4,2,90,49,41,2.4,2.6,2.2,47,24,23,1.2,1.3,1.2,11,6,5,5,3,2,WWWLLWDDLWDWDWWWDDWLDWWWWLWWWWWDWDWWWL,2025-07-27 14:09:22.434918
500,135,2020,Bologna,38,19,19,10,7,3,11,5,6,17,7,10,51,33,18,1.3,1.7,0.9,65,33,32,1.7,1.7,1.7,5,3,2,11,3,8,LWLLLWLWWLLDDDDDLWLLWDDWLLWWLLWDLDDLDL,2025-07-27 14:09:22.434995
501,135,2020,Crotone,38,19,19,6,5,1,5,2,3,27,12,15,45,23,22,1.2,1.2,1.2,92,35,57,2.4,1.8,3.0,3,1,2,14,8,6,LLLDLLDLLLWDLWLLLWLLLLLLLWLLLLLLWLLWDD,2025-07-27 14:09:22.435072
502,135,2020,Fiorentina,38,19,19,9,6,3,13,6,7,16,7,9,47,25,22,1.2,1.3,1.2,59,25,34,1.6,1.3,1.8,9,5,4,12,4,8,WLLDWLDLLDLDDWDLWLWDLLWLLDWLDLLWDDWDLD,2025-07-27 14:09:22.435155
503,135,2020,Torino,38,19,19,7,3,4,16,9,7,15,7,8,50,25,25,1.3,1.3,1.3,69,36,33,1.8,1.9,1.7,8,4,4,9,5,4,LLLDLWDLDLLLDDWDLDDDDDWLLWLDWWDLWDLLDD,2025-07-27 14:09:22.435234
504,135,2020,Verona,38,19,19,11,6,5,12,6,6,15,7,8,46,23,23,1.2,1.2,1.2,48,23,25,1.3,1.2,1.3,7,3,4,9,5,4,WWLDDWDLWDWLDLWDWLWLLWDDWLLLWLLLLDDLDD,2025-07-27 14:09:22.435311
505,135,2020,Inter,38,19,19,28,17,11,7,1,6,3,1,2,89,53,36,2.3,2.8,1.9,35,18,17,0.9,0.9,0.9,14,7,7,1,0,1,WWDLWDDWWWWWWWWLDWDWWWWWWWWWWWDDWWWWLW,2025-07-27 14:09:22.435390
506,135,2020,Benevento,38,19,19,7,2,5,12,7,5,19,10,9,40,19,21,1.1,1.0,1.1,75,39,36,2.0,2.1,1.9,7,3,4,11,5,6,WLWLLLLWDDLDWWLWLLDLDDDLLDLWDLLDLLLLDD,2025-07-27 14:09:22.435468
514,135,2021,Salernitana,38,19,19,7,3,4,10,6,4,21,10,11,33,17,16,0.9,0.9,0.8,78,39,39,2.1,2.1,2.1,2,1,1,16,9,7,LLLLDLWLLWLLLDLLLLWLLDDDDLDLLLWWWDWDDL,2025-07-27 14:09:22.435553
515,135,2021,Spezia,38,19,19,10,5,5,6,3,3,22,11,11,41,21,20,1.1,1.1,1.1,71,30,41,1.9,1.6,2.2,7,4,3,10,4,6,DLLWLLLWLDLWLLLDLDWLWWWDLLLLWLWDLLLLWL,2025-07-27 14:09:22.435630
517,135,2021,Venezia,38,19,19,6,3,3,9,5,4,23,11,12,34,21,13,0.9,1.1,0.7,69,38,31,1.8,2.0,1.6,4,2,2,13,5,8,LLWLLDDWLLDWWLLLDDLLDLLWDLLLLLLLLLLWDD,2025-07-27 14:09:22.435715
487,135,2021,Lazio,38,19,19,18,10,8,10,6,4,10,3,7,77,42,35,2.0,2.2,1.8,58,25,33,1.5,1.3,1.7,9,6,3,6,2,4,WWLDDWLWLWDWLLDWLWWDLWDWWDLWWLWWDLWWDD,2025-07-27 14:09:22.435794
488,135,2021,Sassuolo,38,19,19,13,6,7,11,6,5,14,7,7,64,27,37,1.7,1.4,1.9,66,30,36,1.7,1.6,1.9,3,2,1,6,4,2,WDLLLWLDWWLLDWDDWDLDWLDLDWWWDWLWLLLDWL,2025-07-27 14:09:22.435871
489,135,2021,AC Milan,38,19,19,26,12,14,8,4,4,4,3,1,69,28,41,1.8,1.5,2.2,31,12,19,0.8,0.6,1.0,18,11,7,4,3,1,WWWDWWWWWWWDLLWWDLWWWLDWWDDWWWDDWWWWWW,2025-07-27 14:09:22.435965
490,135,2021,Cagliari,38,19,19,6,3,3,12,6,6,20,10,10,34,20,14,0.9,1.1,0.7,68,33,35,1.8,1.7,1.8,3,1,2,14,4,10,DLLDLLDWLLLLDDDDLLLWWLDWDDWLLLLLWLLDLD,2025-07-27 14:09:22.436033
492,135,2021,Napoli,38,19,19,24,11,13,7,3,4,7,5,2,74,37,37,1.9,1.9,1.9,31,16,15,0.8,0.8,0.8,16,7,9,4,3,1,WWWWWWWWDWWDLWDLLWLDWWWWDDWLWWWLDLWWWW,2025-07-27 14:09:22.436106
494,135,2021,Udinese,38,19,19,11,6,5,14,7,7,13,6,7,61,31,30,1.6,1.6,1.6,58,29,29,1.5,1.5,1.5,8,3,5,9,4,5,DWWLLLDDDDLWLDDLDWLLDWLDDWDLWWWLDWLDLW,2025-07-27 14:09:22.436187
495,135,2021,Genoa,38,19,19,4,3,1,16,8,8,18,8,10,27,14,13,0.7,0.7,0.7,60,25,35,1.6,1.3,1.8,10,7,3,20,9,11,LLWLDDLDLDDDLDLLLLDDLLDDDDDDDWLLLWLWLL,2025-07-27 14:09:22.436268
496,135,2021,Juventus,38,19,19,20,10,10,10,5,5,8,4,4,57,25,32,1.5,1.3,1.7,37,14,23,1.0,0.7,1.2,13,8,5,5,3,2,DLLDWWWWDLLWWLWWDWWDWWDWDDWWWWLWDWWLDL,2025-07-27 14:09:22.436344
497,135,2021,AS Roma,38,19,19,18,10,8,9,6,3,11,3,8,59,26,33,1.6,1.4,1.7,43,16,27,1.1,0.8,1.4,15,10,5,7,4,3,WWWLWLWLDWLLWWLLWWDLLWWDDDWWDWWWDLDLDW,2025-07-27 14:09:22.436425
498,135,2021,Sampdoria,38,19,19,10,6,4,6,3,3,22,10,12,46,29,17,1.2,1.5,0.9,63,32,31,1.7,1.7,1.6,7,3,4,12,3,9,LDDWLLDLWLLLWWLLWDDLLLLWLWLLLWLLLDWLWL,2025-07-27 14:09:22.436500
499,135,2021,Atalanta,38,19,19,16,4,12,11,8,3,11,7,4,65,31,34,1.7,1.6,1.8,48,29,19,1.3,1.5,1.0,10,5,5,9,4,5,WDLWWDLWDWDWWWWWWLDWDDLDLWLDWLLLWDDWLL,2025-07-27 14:09:22.436575
500,135,2021,Bologna,38,19,19,12,8,4,10,4,6,16,7,9,44,25,19,1.2,1.3,1.0,55,24,31,1.4,1.3,1.6,13,7,6,12,6,6,WDWLDLWDLLWWLWWLLLWLLLDLWDDLLDWDDWDLLW,2025-07-27 14:09:22.436649
502,135,2021,Fiorentina,38,19,19,19,13,6,5,2,3,14,4,10,59,38,21,1.6,2.0,1.1,51,20,31,1.3,1.1,1.6,11,10,1,7,2,5,LWWWLWLLWLWLWLWWWDDLWDLWWLDWDWWWLLLWLW,2025-07-27 14:09:22.436726
503,135,2021,Torino,38,19,19,13,8,5,11,5,6,14,6,8,46,29,17,1.2,1.5,0.9,41,21,20,1.1,1.1,1.1,9,5,4,12,4,8,LLWWDDLLWLWLWLDDWWLWWDLLDLDDLWDDWDWLWL,2025-07-27 14:09:22.436800
504,135,2021,Verona,38,19,19,14,9,5,11,3,8,13,7,6,65,34,31,1.7,1.8,1.6,59,25,34,1.6,1.3,1.8,4,4,0,6,2,4,LLLWDDWLWDWDWLDWLLDWLWWLWDWDLDWLWDWLLD,2025-07-27 14:09:22.436874
505,135,2021,Inter,38,19,19,25,14,11,9,3,6,4,2,2,84,48,36,2.2,2.5,1.9,32,16,16,0.8,0.8,0.8,15,8,7,3,1,2,WWDWWDWLDWWDWWWWWWWWDWLDLDWDDWWWWLWWWW,2025-07-27 14:09:22.436967
511,135,2021,Empoli,38,19,19,10,4,6,11,5,6,17,10,7,50,28,22,1.3,1.5,1.2,70,44,26,1.8,2.3,1.4,7,1,6,9,3,6,LWLLWWLLWLWDLWDWWDLDLDLDDLLDLDLDLWLLDW,2025-07-27 14:09:22.437046
514,135,2022,Salernitana,38,19,19,9,7,2,15,6,9,14,6,8,48,30,18,1.3,1.6,0.9,62,26,36,1.6,1.4,1.9,7,5,2,11,4,7,LDWDDDLLWLWWDLLLDLLWLLLWDDDDDDWDDLWDWL,2025-07-27 14:09:22.437133
515,135,2022,Spezia,39,20,19,6,4,2,13,8,5,20,8,12,32,19,13,0.8,1.0,0.7,65,33,32,1.7,1.7,1.7,6,4,2,18,8,10,WLDLDLWLLDLLLDWDDWLLLDLDDWLDDLDLLLWDLLL,2025-07-27 14:09:22.437212
520,135,2022,Cremonese,38,19,19,5,4,1,12,4,8,21,11,10,36,15,21,0.9,0.8,1.1,69,31,38,1.8,1.6,2.0,6,6,0,14,8,6,LLLLDDLDLDLDDDLLLLDLLLDWLLDLWWLDDWLLLW,2025-07-27 14:09:22.437287
1579,135,2022,Monza,38,19,19,14,7,7,10,5,5,14,7,7,48,25,23,1.3,1.3,1.2,52,22,30,1.4,1.2,1.6,10,5,5,9,4,5,LLLLLDWWWLLLWLWDDWDWDWLLWDDLDWWWDDWWLL,2025-07-27 14:09:22.437343
867,135,2022,Lecce,38,19,19,8,3,5,12,8,4,18,8,10,33,18,15,0.9,0.9,0.8,46,24,22,1.2,1.3,1.2,6,2,4,14,5,9,LLDDLDWDLDLLDWWWDDLLWDWLLLLLLDLWLLDDWL,2025-07-27 14:09:22.437412
487,135,2022,Lazio,38,19,19,22,11,11,8,4,4,8,4,4,60,32,28,1.6,1.7,1.5,30,18,12,0.8,0.9,0.6,21,8,13,7,3,4,WDWDLWWWWDWLWWLLDWWDDLWWWDWWWWLLWLDWWW,2025-07-27 14:09:22.437467
488,135,2022,Sassuolo,38,19,19,12,8,4,9,4,5,17,7,10,47,24,23,1.2,1.3,1.2,61,23,38,1.6,1.2,2.0,9,6,3,10,3,7,LWDDDLWWLLWLLDLLLLDWWDLWWWWDLWLWLDLLDL,2025-07-27 14:09:22.437553
489,135,2022,AC Milan,38,19,19,20,13,7,10,4,6,8,2,6,64,41,23,1.7,2.2,1.2,43,20,23,1.1,1.1,1.2,12,7,5,6,1,5,WDWDWWLWWWWLWDWWDDLLLWWWLDLWDDWDDWLWWW,2025-07-27 14:09:22.437616
492,135,2022,Napoli,38,19,19,28,14,14,6,3,3,4,2,2,77,40,37,2.0,2.1,1.9,28,15,13,0.7,0.8,0.7,18,9,9,6,3,3,WWDDWWWWWWWWWWWLWWWWWWWWLWWLWDWDDWLWDW,2025-07-27 14:09:22.437679
494,135,2022,Udinese,38,19,19,11,6,5,13,9,4,14,4,10,47,30,17,1.2,1.6,0.9,48,20,28,1.3,1.1,1.5,10,5,5,12,3,9,LDWWWWWWDDLDDDLDLLWDLDLDDWWLDLWLDWLLLL,2025-07-27 14:09:22.437744
496,135,2022,Juventus,38,19,19,22,13,9,6,3,3,10,3,7,56,38,18,1.5,2.0,0.9,33,15,18,0.9,0.8,0.9,20,10,10,8,3,5,WDDWDDLWLWWWWWWWWLDLWWWWLWWWLLLDWWWLLW,2025-07-27 14:09:22.437798
497,135,2022,AS Roma,38,19,19,18,11,7,9,3,6,11,5,6,50,28,22,1.3,1.5,1.2,38,15,23,1.0,0.8,1.2,14,9,5,7,4,3,WWDWLWLWWWLWLDDWDWWLWDWLWLLWWWLDDLDDLW,2025-07-27 14:09:22.437878
498,135,2022,Sampdoria,38,19,19,3,1,2,10,7,3,25,11,14,24,12,12,0.6,0.6,0.6,71,28,43,1.9,1.5,2.3,4,3,1,21,11,10,LDLDLLLLDLWLLLLWLLLLDDLLDLWLLDDLLLDLDL,2025-07-27 14:09:22.437974
499,135,2022,Atalanta,38,19,19,19,10,9,7,3,4,12,6,6,66,38,28,1.7,2.0,1.5,48,26,22,1.3,1.4,1.2,9,3,6,8,4,4,WDWWWDWWDWLWLLLDWWDWLWLLDLWWLDWWWLLWLW,2025-07-27 14:09:22.438058
500,135,2022,Bologna,38,19,19,14,7,7,12,9,3,12,3,9,53,24,29,1.4,1.3,1.5,49,14,35,1.3,0.7,1.8,8,7,1,8,4,4,LDLDDWLLDLWWWLWLLWDWWLWWLDDWWDLDLDDWDW,2025-07-27 14:09:22.438135
502,135,2022,Fiorentina,38,19,19,15,9,6,11,6,5,12,4,8,53,30,23,1.4,1.6,1.2,43,22,21,1.1,1.2,1.1,10,5,5,9,3,6,WDDLDLWLLDLWWWLDWLLDLLDWWWWWDDLWDLWDWW,2025-07-27 14:09:22.438213
503,135,2022,Torino,38,19,19,14,5,9,11,7,4,13,7,6,42,15,27,1.1,0.8,1.4,41,19,22,1.1,1.0,1.2,11,5,6,9,7,2,WDWLWLLLDLWWLWDDDLWDWLDLWWLDLDWLWDWDWL,2025-07-27 14:09:22.438292
504,135,2022,Verona,39,19,20,8,6,2,10,3,7,21,10,11,34,20,14,0.9,1.1,0.7,60,32,28,1.5,1.7,1.4,6,3,3,13,5,8,LDLDWLLLLLLLLLLDWLWDDWLLDDLLWDWDLWLLDLW,2025-07-27 14:09:22.438369
505,135,2022,Inter,38,19,19,23,14,9,3,0,3,12,5,7,71,37,34,1.9,1.9,1.8,42,14,28,1.1,0.7,1.5,13,8,5,7,4,3,WWLWLWLLWWWWLWWWDWLWWDWLWLLLDLWWWWWLWW,2025-07-27 14:09:22.438444
511,135,2022,Empoli,38,19,19,10,8,2,13,4,9,15,7,8,37,22,15,1.0,1.2,0.8,49,23,26,1.3,1.2,1.4,9,6,3,12,6,6,LDDDDLWLDWLLWLWDDWWDLDDLLLLWDLLLWWDWDL,2025-07-27 14:09:22.438524
512,135,2023,Frosinone,38,19,19,8,7,1,11,4,7,19,8,11,44,28,16,1.2,1.5,0.8,69,32,37,1.8,1.7,1.9,7,3,4,12,5,7,LWDWDDLWLLWLWLDLLLLLWDLLLLDLLDDDDWDLWL,2025-07-27 14:09:22.438603
514,135,2023,Salernitana,38,19,19,2,1,1,11,5,6,25,13,12,32,17,15,0.8,0.9,0.8,81,38,43,2.1,2.0,2.3,2,0,2,15,6,9,DDLLDLLLDLLDWLLLDWLLLLDLLLDLLLDLLLLDLD,2025-07-27 14:09:22.438692
1579,135,2023,Monza,38,19,19,11,6,5,12,6,6,15,7,8,39,23,16,1.0,1.2,0.8,51,26,25,1.3,1.4,1.3,12,7,5,14,4,10,LWLDDDWWLDWDDLWLLDWLLWDDWWLWWLLDLDDLLL,2025-07-27 14:09:22.438757
867,135,2023,Lecce,38,19,19,8,6,2,14,6,8,16,7,9,32,17,15,0.8,0.9,0.8,54,27,27,1.4,1.4,1.4,7,4,3,16,8,8,WDWDWLLDDLLDDDDWLLDLLLWLLLDLWDLWWDDLLD,2025-07-27 14:09:22.438816
487,135,2023,Lazio,38,19,19,18,10,8,7,4,3,13,5,8,49,23,26,1.3,1.2,1.4,39,14,25,1.0,0.7,1.3,13,9,4,8,5,3,LLWLDWLWWWLDLWDLWWWWDLWLWLLLWWLWWWDWDD,2025-07-27 14:09:22.438870
488,135,2023,Sassuolo,38,19,19,7,5,2,9,5,4,22,9,13,43,23,20,1.1,1.2,1.1,75,34,41,2.0,1.8,2.2,3,3,0,12,5,7,LLWLWWLDLDLDWLLDLLWLLLDLLLLWLDDDLLWLLD,2025-07-27 14:09:22.438939
489,135,2023,AC Milan,38,19,19,22,12,10,9,4,5,7,3,4,76,38,38,2.0,2.0,2.0,49,17,32,1.3,0.9,1.7,13,8,5,3,2,1,WWWLWWWWLDLDWWLWDWWWWDWWLDWWWWWDLDDWLD,2025-07-27 14:09:22.439003
490,135,2023,Cagliari,38,19,19,8,6,2,12,7,5,18,6,12,42,28,14,1.1,1.5,0.7,68,32,36,1.8,1.7,1.9,5,2,3,11,3,8,DLLDLLLLDWWLDLWLLDDWLLLLDDWWLDWDDLDLWL,2025-07-27 14:09:22.439062
492,135,2023,Napoli,38,19,19,13,6,7,14,7,7,11,6,5,55,24,31,1.4,1.3,1.6,48,27,21,1.3,1.4,1.1,7,3,4,13,6,7,WWLDDWWLWDWLWLLWLDLWDWLDDWWDDLWDLDDLDD,2025-07-27 14:09:22.439123
494,135,2023,Udinese,38,19,19,6,1,5,19,11,8,13,7,6,37,21,16,1.0,1.1,0.8,53,29,24,1.4,1.5,1.3,9,3,6,11,5,6,LDDDLLDDDDWDLDLDDWLDLLDWDLDWLDLLLDDWDW,2025-07-27 14:09:22.439211
495,135,2023,Genoa,38,19,19,12,8,4,13,6,7,13,5,8,45,27,18,1.2,1.4,0.9,45,22,23,1.2,1.2,1.2,9,6,3,10,3,7,LWLDLWDLLWLWLDLDWDDDWWDLDWLLDDWDLWDWLW,2025-07-27 14:09:22.439298
496,135,2023,Juventus,38,19,19,19,11,8,14,7,7,5,1,4,54,26,28,1.4,1.4,1.5,31,11,20,0.8,0.6,1.1,17,10,7,7,3,4,WDWWLWDWWWWWDWWDWWWWWDLLDWLDDLWDDDDDDW,2025-07-27 14:09:22.439379
497,135,2023,AS Roma,38,19,19,18,12,6,9,4,5,11,3,8,65,38,27,1.7,2.0,1.4,46,19,27,1.2,1.0,1.4,11,8,3,5,0,5,DLLWDLWWWLWDWWDLWLDLWWWLWWWDWDWLWDDLWL,2025-07-27 14:09:22.439459
499,135,2023,Atalanta,38,19,19,21,13,8,6,2,4,11,4,7,72,42,30,1.9,2.2,1.6,42,16,26,1.1,0.8,1.4,15,10,5,4,1,3,WLWLWWDLWWLDLLWWLWDWWWWWDLLDWLDWWWWWWL,2025-07-27 14:09:22.439534
500,135,2023,Bologna,38,19,19,18,12,6,14,5,9,6,2,4,54,33,21,1.4,1.7,1.1,32,12,20,0.8,0.6,1.1,17,11,6,10,4,6,LDWDDDWDWDWLWDWWWLDLDWWWWWWLWWDDWDDWDL,2025-07-27 14:09:22.439624
502,135,2023,Fiorentina,38,19,19,17,10,7,9,5,4,12,4,8,61,37,24,1.6,1.9,1.3,46,22,24,1.2,1.2,1.3,8,4,4,10,3,7,WDLWWDWWLLLWLWDWWWLDLLWLDWDDLLDWWLWDWW,2025-07-27 14:09:22.439707
503,135,2023,Torino,38,19,19,13,8,5,14,9,5,11,2,9,36,18,18,0.9,0.9,0.9,36,9,27,0.9,0.5,1.4,18,13,5,17,9,8,DLWWDLDLLWWDLWDWDLWDWDDWLLDDWWLDDLDWWL,2025-07-27 14:09:22.439788
504,135,2023,Verona,38,19,19,9,6,3,11,6,5,18,7,11,38,23,15,1.0,1.2,0.8,51,26,25,1.3,1.4,1.3,8,4,4,11,3,8,WWLDLLDLLLLLDDDLWLLWLDLDDLWWLDLDWLWLWD,2025-07-27 14:09:22.439867
505,135,2023,Inter,38,19,19,29,14,15,7,4,3,2,1,1,89,44,45,2.3,2.3,2.4,22,11,11,0.6,0.6,0.6,21,11,10,1,0,1,WWWWWLWDWWWWDWWWWDWWWWWWWWWWDWWDWWLWDD,2025-07-27 14:09:22.439949
511,135,2023,Empoli,38,19,19,9,5,4,9,5,4,20,9,11,29,15,14,0.8,0.8,0.7,54,23,31,1.4,1.2,1.6,9,6,3,21,11,10,LLLLLWLDWLLWLDDLLDLLWDDWDWLLLLWLWLDLDW,2025-07-27 14:09:22.440030
517,135,2024,Venezia,38,19,19,5,5,0,14,5,9,19,9,10,32,17,15,0.8,0.9,0.8,56,22,34,1.5,1.2,1.8,6,4,2,17,9,8,LDLLWLLLDWLLLLDDWLDLDDLLLDDDDLDWDLDWLL,2025-07-27 14:09:22.440109
523,135,2024,Parma,38,19,19,7,5,2,15,6,9,16,8,8,44,25,19,1.2,1.3,1.0,58,28,30,1.5,1.5,1.6,7,3,4,11,4,7,DWLLDLDDDDLWLWLLLWDLDLLLLWLDDDDDWDLLDW,2025-07-27 14:09:22.440194
895,135,2024,Como,38,19,19,13,8,5,10,5,5,15,6,9,49,28,21,1.3,1.5,1.1,52,26,26,1.4,1.4,1.4,7,4,3,8,2,6,LDLDWWLDLLLDLDDWLWDLWLLLWWLDLDWWWWWWDL,2025-07-27 14:09:22.440276
1579,135,2024,Monza,38,19,19,3,1,2,9,5,4,26,13,13,28,13,15,0.7,0.7,0.8,69,31,38,1.8,1.6,2.0,3,1,2,17,8,9,DLDDLLDWDLLLDDLLLLLWLLLLDLLLDLLLLLLWLL,2025-07-27 14:09:22.440343
867,135,2024,Lecce,38,19,19,8,4,4,10,6,4,20,9,11,27,13,14,0.7,0.7,0.7,58,31,27,1.5,1.6,1.4,9,5,4,18,9,9,LLWDDLLLLWLDWDLWLLDWLLWDDLLLLLDLLDLDWW,2025-07-27 14:09:22.440401
487,135,2024,Lazio,38,19,19,18,7,11,11,9,2,9,3,6,61,33,28,1.6,1.7,1.5,49,26,23,1.3,1.4,1.2,9,2,7,6,2,4,WLDWLWWLWWWWWLWLWDLDWLWWDDWDLDWDWDWDDL,2025-07-27 14:09:22.440464
489,135,2024,AC Milan,38,19,19,18,9,9,9,7,2,11,3,8,61,30,31,1.6,1.6,1.6,43,16,27,1.1,0.8,1.4,13,8,5,5,4,1,DLDWWWLWLWDDWLDWDDWLWDWWLLLWWLDWLWWWLW,2025-07-27 14:09:22.440520
490,135,2024,Cagliari,38,19,19,9,6,3,9,4,5,20,9,11,40,24,16,1.1,1.3,0.8,56,28,28,1.5,1.5,1.5,7,4,3,15,7,8,DDLLLWDWLLLDDWLLLLWDWLLWDLLDLWDLLWLLWL,2025-07-27 14:09:22.440585
492,135,2024,Napoli,38,19,19,24,14,10,10,3,7,4,2,2,59,32,27,1.6,1.7,1.4,27,13,14,0.7,0.7,0.7,19,9,10,6,2,4,LWWWDWWWWWLDWWLWWWWWWWDDDLDWDWDWWWWDDW,2025-07-27 14:09:22.440635
494,135,2024,Udinese,38,19,19,12,7,5,8,3,5,18,9,9,41,22,19,1.1,1.2,1.0,56,27,29,1.5,1.4,1.5,9,7,2,12,6,6,DWWWLLWLWLLLDLWLWDDDLLWDWWWDLLLLLDWLLL,2025-07-27 14:09:22.440694
495,135,2024,Genoa,38,19,19,10,5,5,13,7,6,15,7,8,37,21,16,1.0,1.1,0.8,49,25,24,1.3,1.3,1.3,11,5,6,13,5,8,DWLDLLLDLLWDDWDDLWDWLWLDWLDDWLWDLLLDLW,2025-07-27 14:09:22.440762
496,135,2024,Juventus,38,19,19,18,11,7,16,7,9,4,1,3,58,31,27,1.5,1.6,1.4,35,15,20,0.9,0.8,1.1,17,11,6,7,3,4,WWDDDWDWDDWWDDDDWDDDWLWWWWWLLWDWLWDDWW,2025-07-27 14:09:22.440822
497,135,2024,AS Roma,38,19,19,20,13,7,9,2,7,9,4,5,56,37,19,1.5,1.9,1.0,35,15,20,0.9,0.8,1.1,16,8,8,6,2,4,DLDDWWDLLWLLLLWLWDWDWWDWWWWWWWDDWWWLWW,2025-07-27 14:09:22.440890
499,135,2024,Atalanta,38,19,19,22,9,13,8,5,3,8,5,3,78,36,42,2.1,1.9,2.2,37,24,13,1.0,1.3,0.7,15,4,11,7,4,3,WLLWLDWWWWWWWWWWWDDDLWDWDWDWLLLWWDWWWL,2025-07-27 14:09:22.440961
500,135,2024,Bologna,38,19,19,16,10,6,14,7,7,8,2,6,57,33,24,1.5,1.7,1.3,47,18,29,1.2,0.9,1.5,12,7,5,7,1,6,DLDDWDDDWWWLWDWWLDDWDWDWLWWWWWDLWDDLLL,2025-07-27 14:09:22.441021
502,135,2024,Fiorentina,38,19,19,19,12,7,8,4,4,11,3,8,60,32,28,1.6,1.7,1.5,41,18,23,1.1,0.9,1.2,12,7,5,8,4,4,DDDLWDWWWWWWWWLLDLLDWWWLLLWLWWDDWWLLWW,2025-07-27 14:09:22.441074
503,135,2024,Torino,38,19,19,10,6,4,14,7,7,14,6,8,39,17,22,1.0,0.9,1.2,45,18,27,1.2,0.9,1.4,10,6,4,13,7,6,DWWDWLLLWLLLDLDWLDDDDWDDLWWDWDDLWLDLLL,2025-07-27 14:09:22.441152
504,135,2024,Verona,38,19,19,10,4,6,7,5,2,21,10,11,34,15,19,0.9,0.8,1.0,66,36,30,1.7,1.9,1.6,8,5,3,17,10,7,WLWLLLWLLLWLLLLWLWDLLDWLLWLLWDDDLLLDDW,2025-07-27 14:09:22.441228
505,135,2024,Inter,38,19,19,24,13,11,9,4,5,5,2,3,79,40,39,2.1,2.1,2.1,35,21,14,0.9,1.1,0.7,16,6,10,4,1,3,DWWDLWWWDWWDWWWWWWDWWDLWLWDWWWDWLLWWDW,2025-07-27 14:09:22.441309
511,135,2024,Empoli,38,19,19,6,2,4,13,7,6,19,10,9,33,10,23,0.9,0.5,1.2,59,26,33,1.6,1.4,1.7,6,5,1,15,11,4,DWDDWDLLDLWDDLWLLLDLLDLLLLDLLDDLDLLWWL,2025-07-27 14:09:22.441371
157,78,2020,Bayern München,34,17,17,24,13,11,6,4,2,4,0,4,99,64,35,2.9,3.8,2.1,44,21,23,1.3,1.2,1.4,9,5,4,0,0,0,WLWWWWWDWDDWWWLWWWWWDLWWWWWDWWLWDW,2025-07-27 14:09:22.441431
159,78,2020,Hertha BSC,34,17,17,8,5,3,11,5,6,15,7,8,41,21,20,1.2,1.2,1.2,52,26,26,1.5,1.5,1.5,9,6,3,12,7,5,WLLLLDWLDWDDLWLDLLLLDLLWLWDDDWDWDL,2025-07-27 14:09:22.441486
160,78,2020,SC Freiburg,34,17,17,12,7,5,9,6,3,13,4,9,52,33,19,1.5,1.9,1.1,52,23,29,1.5,1.4,1.7,6,4,2,9,2,7,WDLDDLLLDDWWWWWLDWLWDLWLLWLLWDLWDL,2025-07-27 14:09:22.441548
161,78,2020,VfL Wolfsburg,34,17,17,17,10,7,10,4,6,7,3,4,61,32,29,1.8,1.9,1.7,37,16,21,1.1,0.9,1.2,14,9,5,5,4,1,DDDDWDWWWDWLWLDDWWWWDWWLWWWLLWLWDL,2025-07-27 14:09:22.441626
162,78,2020,Werder Bremen,34,17,17,7,3,4,10,5,5,17,9,8,36,16,20,1.1,0.9,1.2,57,28,29,1.7,1.6,1.7,6,4,2,9,4,5,LWWDDDDDLLLLWLDWLWDDLWDWLLLLLLLDLL,2025-07-27 14:09:22.441705
163,78,2020,Borussia Mönchengladbach,34,17,17,13,8,5,10,4,6,11,5,6,64,32,32,1.9,1.9,1.9,56,19,37,1.6,1.1,2.2,7,4,3,4,1,3,LDWDWWLDWDDDLWWDWWDLDLLLLWWDWLWLLW,2025-07-27 14:09:22.441784
164,78,2020,FSV Mainz 05,34,17,17,10,4,6,9,4,5,15,9,6,39,16,23,1.1,0.9,1.4,56,26,30,1.6,1.5,1.8,5,2,3,10,6,4,LLLLLLDWDLLDLLLDLWLWDWLDWWDWWWDDLW,2025-07-27 14:09:22.441866
165,78,2020,Borussia Dortmund,34,17,17,20,11,9,4,2,2,10,4,6,75,40,35,2.2,2.4,2.1,46,20,26,1.4,1.2,1.5,11,7,4,1,0,1,WLWWWWLWLDLWLWWDLLWLDWWLWDLWWWWWWW,2025-07-27 14:09:22.441943
167,78,2020,1899 Hoffenheim,34,17,17,11,8,3,10,3,7,13,6,7,52,32,20,1.5,1.9,1.2,54,24,30,1.6,1.4,1.8,6,4,2,7,4,3,WWLLDLLDDWLLWLLDWWLLDWDWLLLDDWDWDW,2025-07-27 14:09:22.442027
168,78,2020,Bayer Leverkusen,34,17,17,14,8,6,10,5,5,10,4,6,53,34,19,1.6,2.0,1.1,39,22,17,1.1,1.3,1.0,9,2,7,9,2,7,DDDWWWWWDWWWLLDLWLLWDDLWLLWDWLWDDL,2025-07-27 14:09:22.442109
169,78,2020,Eintracht Frankfurt,34,17,17,16,10,6,12,7,5,6,0,6,69,37,32,2.0,2.2,1.9,53,20,33,1.6,1.2,1.9,4,2,2,2,0,2,DWWDLDDDDDLDWWWWDWWWWWLDDWWWLWLDLW,2025-07-27 14:09:22.442189
170,78,2020,FC Augsburg,34,17,17,10,6,4,6,4,2,18,7,11,36,21,15,1.1,1.2,0.9,54,25,29,1.6,1.5,1.7,7,3,4,11,6,5,WWDLLWLDDLDWLWLLLWLLLDWLWLWLDLLLWL,2025-07-27 14:09:22.442269
172,78,2020,VfB Stuttgart,34,17,17,12,5,7,9,6,3,13,6,7,56,27,29,1.6,1.6,1.7,55,26,29,1.6,1.5,1.7,5,3,2,6,2,4,LWDWDDDDLWWDLLWDLLWLDWWDWLWLLLLWWL,2025-07-27 14:09:22.442348
173,78,2020,RB Leipzig,34,17,17,19,11,8,8,4,4,7,2,5,60,29,31,1.8,1.7,1.8,32,13,19,0.9,0.8,1.1,15,8,7,4,3,1,WDWWWLWDWDWWDWLDWLWWWWWWDWLWDLWLDL,2025-07-27 14:09:22.442431
174,78,2020,FC Schalke 04,34,17,17,3,3,0,7,3,4,24,11,13,25,14,11,0.7,0.8,0.6,86,34,52,2.5,2.0,3.1,4,3,1,18,9,9,LLLDLDDLLLDLLLWLLLDLDLLDLLLWLLLLWL,2025-07-27 14:09:22.442515
182,78,2020,Union Berlin,34,17,17,12,8,4,14,8,6,8,1,7,50,32,18,1.5,1.9,1.1,43,18,25,1.3,1.1,1.5,7,4,3,6,1,5,LDWDDWWWDLDDWWDWLLDLDWDDWLDDWLWLDW,2025-07-27 14:09:22.442597
188,78,2020,Arminia Bielefeld,34,17,17,9,6,3,8,2,6,17,9,8,26,13,13,0.8,0.8,0.8,52,23,29,1.5,1.4,1.7,11,6,5,15,7,8,DWLLLLLLLWLLWLWDWLLDLLDLWLDWDWLDDW,2025-07-27 14:09:22.442674
191,78,2020,Holstein Kiel,2,1,1,1,0,1,0,0,0,1,1,0,2,1,1,1.0,1.0,1.0,5,5,0,2.5,5.0,0.0,1,0,1,0,0,0,WL,2025-07-27 14:09:22.442753
192,78,2020,1.FC Köln,36,18,18,9,3,6,9,5,4,18,10,8,39,20,19,1.1,1.1,1.1,62,32,30,1.7,1.8,1.7,5,2,3,13,5,8,LLLDDLDLWDWLDLLDWLWWLLLDLDLLLWWLDWLW,2025-07-27 14:09:22.442830
157,78,2021,Bayern München,34,17,17,24,13,11,5,2,3,5,2,3,97,48,49,2.9,2.8,2.9,37,15,22,1.1,0.9,1.3,11,7,4,0,0,0,DWWWWWLWWWWLWWWWWLWWWLWWDDWWWWWLDD,2025-07-27 14:09:22.442907
159,78,2021,Hertha BSC,36,18,18,10,6,4,6,3,3,20,9,11,39,24,15,1.1,1.3,0.8,72,34,38,2.0,1.9,2.1,7,4,3,9,1,8,LLLWWLLWWLDLDDWLWLDLDLLLLLWLLWWDLLLW,2025-07-27 14:09:22.442987
160,78,2021,SC Freiburg,34,17,17,15,8,7,10,5,5,9,4,5,58,32,26,1.7,1.9,1.5,46,25,21,1.4,1.5,1.2,10,4,6,6,1,5,DWWDDWWDWWLLLWLDWDLWLDWWDWDLWWDWLL,2025-07-27 14:09:22.443067
161,78,2021,VfL Wolfsburg,34,17,17,12,7,5,6,3,3,16,7,9,43,25,18,1.3,1.5,1.1,54,21,33,1.6,1.2,1.9,11,7,4,10,4,6,WWWWDLLLLWWDLLLLLLDLWWLDWLLLWLWDWD,2025-07-27 14:09:22.443151
163,78,2021,Borussia Mönchengladbach,34,17,17,12,8,4,9,4,5,13,5,8,54,33,21,1.6,1.9,1.2,61,27,34,1.8,1.6,2.0,5,3,2,5,1,4,DLLWLWWDLWDWLLLLDWLLDWLDLWWDWLDWDW,2025-07-27 14:09:22.443225
164,78,2021,FSV Mainz 05,34,17,17,13,10,3,7,5,2,14,2,12,50,33,17,1.5,1.9,1.0,45,11,34,1.3,0.6,2.0,10,9,1,7,3,4,WLWWDLLLWWDDLWLWLLWLWDWLLWDLLDLWWD,2025-07-27 14:09:22.443297
165,78,2021,Borussia Dortmund,34,17,17,22,13,9,3,0,3,9,4,5,85,52,33,2.5,3.1,1.9,52,28,24,1.5,1.6,1.4,7,4,3,1,0,1,WLWWWLWWWWLWWLDWLWWWLWWDWWDLWWLLWW,2025-07-27 14:09:22.443369
167,78,2021,1899 Hoffenheim,34,17,17,13,8,5,7,4,3,14,5,9,58,34,24,1.7,2.0,1.4,60,24,36,1.8,1.4,2.1,8,5,3,8,2,6,WDLLDWLWLWLWWWWDDWLLLWWWWDLLLDDLLL,2025-07-27 14:09:22.443436
168,78,2021,Bayer Leverkusen,34,17,17,19,10,9,7,2,5,8,5,3,80,39,41,2.4,2.3,2.4,47,23,24,1.4,1.4,1.4,8,5,3,4,3,1,DWWLWWWLDLDWWWLDLDWWWWLWDLWWDLWWWW,2025-07-27 14:09:22.443505
169,78,2021,Eintracht Frankfurt,34,17,17,10,4,6,12,7,5,12,6,6,45,20,25,1.3,1.2,1.5,49,22,27,1.4,1.3,1.6,5,3,2,10,5,5,LDDDDDWLLDWWWLWWWLDLWLLLWWDDLLDLDD,2025-07-27 14:09:22.443576
170,78,2021,FC Augsburg,34,17,17,10,7,3,8,4,4,16,6,10,39,25,14,1.1,1.5,0.8,56,26,30,1.6,1.5,1.8,9,3,6,9,2,7,LDLDWLLDLWLWDLWDDLDLWLLDWLWWLLWLLW,2025-07-27 14:09:22.443651
172,78,2021,VfB Stuttgart,34,17,17,7,6,1,12,4,8,15,7,8,41,28,13,1.2,1.6,0.8,59,32,27,1.7,1.9,1.6,4,0,4,11,4,7,WLLDLDWDDLLLWDWLLDLLLLDLWDWDLDLDDW,2025-07-27 14:09:22.443736
173,78,2021,RB Leipzig,34,17,17,17,11,6,7,2,5,10,4,6,72,43,29,2.1,2.5,1.7,37,17,20,1.1,1.0,1.2,10,7,3,5,2,3,LWLLDWWDWDWLLLWDLWWWLWWWDWDWWWLLWD,2025-07-27 14:09:22.443814
175,78,2021,Hamburger SV,2,1,1,1,0,1,0,0,0,1,1,0,1,0,1,0.5,0.0,1.0,2,2,0,1.0,2.0,0.0,1,0,1,1,1,0,WL,2025-07-27 14:09:22.443892
176,78,2021,VfL Bochum,34,17,17,12,8,4,6,4,2,16,5,11,38,21,17,1.1,1.2,1.0,52,17,35,1.5,1.0,2.1,7,6,1,13,6,7,LWLLLDLWWLWLWWDLLWLDDWDLWLLWDLLWWL,2025-07-27 14:09:22.443970
178,78,2021,SpVgg Greuther Fürth,34,17,17,3,3,0,9,5,4,22,9,13,28,15,13,0.8,0.9,0.8,82,33,49,2.4,1.9,2.9,6,4,2,11,6,5,LDLLLLLLLLLLLLWLDDDWLWLDLLDDLDLDLL,2025-07-27 14:09:22.444052
182,78,2021,Union Berlin,34,17,17,16,10,6,9,5,4,9,2,7,50,25,25,1.5,1.5,1.5,44,17,27,1.3,1.0,1.6,8,7,1,8,3,5,DDWDLWWWDLDWLWLDWDWWLLLWLDLWWWWDWW,2025-07-27 14:09:22.444130
188,78,2021,Arminia Bielefeld,34,17,17,5,2,3,13,10,3,16,5,11,27,15,12,0.8,0.9,0.7,53,23,30,1.6,1.4,1.8,7,4,3,13,5,8,DDDLDLLDLLWDLDLWWDDWDLWLLLLDLLLDLD,2025-07-27 14:09:22.444192
192,78,2021,1.FC Köln,34,17,17,14,9,5,10,4,6,10,4,6,52,27,25,1.5,1.6,1.5,49,21,28,1.4,1.2,1.6,4,3,1,7,4,3,WLWDDDWLDLDDWDLWWWLDWLWDLWDLWWWWLL,2025-07-27 14:09:22.444249
157,78,2022,Bayern München,34,17,17,21,11,10,8,5,3,5,1,4,92,53,39,2.7,3.1,2.3,38,17,21,1.1,1.0,1.2,11,7,4,1,0,1,WWWDDDLWDWWWWWWDDDWWLWWWLWWDLWWWLW,2025-07-27 14:09:22.444299
159,78,2022,Hertha BSC,34,17,17,7,5,2,8,6,2,19,6,13,42,24,18,1.2,1.4,1.1,69,27,42,2.0,1.6,2.5,3,2,1,8,4,4,LDLLWDDDDLWLLLWLLLLWLWLDLDLLLLWLDW,2025-07-27 14:09:22.444366
160,78,2022,SC Freiburg,34,17,17,17,10,7,8,4,4,9,3,6,51,28,23,1.5,1.6,1.4,44,13,31,1.3,0.8,1.8,13,6,7,7,3,4,WLWWWDDWDLWWWLWLDWLWWDDWDDLWWWLLWL,2025-07-27 14:09:22.444425
161,78,2022,VfL Wolfsburg,34,17,17,13,6,7,10,7,3,11,4,7,57,34,23,1.7,2.0,1.4,48,25,23,1.4,1.5,1.4,12,6,6,10,3,7,DLDLLWLWDDDWWWWWWLLDLWDDWDLDWWLWLL,2025-07-27 14:09:22.444482
162,78,2022,Werder Bremen,34,17,17,10,5,5,6,2,4,18,10,8,51,26,25,1.5,1.5,1.5,64,28,36,1.9,1.6,2.1,4,2,2,6,3,3,DDWLWLDWWLLWWLLLLWWLLWLLDLDLWLLLDL,2025-07-27 14:09:22.444545
163,78,2022,Borussia Mönchengladbach,34,17,17,11,10,1,10,3,7,13,4,9,52,33,19,1.5,1.9,1.1,55,18,37,1.6,1.1,2.2,9,7,2,9,4,5,WDWDLDWLWDLLWLWLLWDLWLDLDDWDLLWLDW,2025-07-27 14:09:22.444619
164,78,2022,FSV Mainz 05,34,17,17,12,6,6,10,6,4,12,5,7,54,31,23,1.6,1.8,1.4,55,25,30,1.6,1.5,1.8,7,4,3,6,3,3,WDWLWLDLDWWLLLDDLWLWWWWDDWDDWLLLLD,2025-07-27 14:09:22.444703
165,78,2022,Borussia Dortmund,34,17,17,22,14,8,5,2,3,7,1,6,83,55,28,2.4,3.2,1.6,44,17,27,1.3,1.0,1.6,12,7,5,3,0,3,WWLWWLWLDLWWWLLWWWWWWWWDWLWDWDWWWD,2025-07-27 14:09:22.444785
167,78,2022,1899 Hoffenheim,34,17,17,10,7,3,6,2,4,18,8,10,48,28,20,1.4,1.6,1.2,57,29,28,1.7,1.7,1.6,5,3,2,7,3,4,LWWWLWDDLWLDLLLLDLLLLLLLWWWDLLWLWD,2025-07-27 14:09:22.444862
168,78,2022,Bayer Leverkusen,34,17,17,14,8,6,8,3,5,12,6,6,57,35,22,1.7,2.1,1.3,49,23,26,1.4,1.4,1.5,9,5,4,9,2,7,LLLWLDDLWLDLWWWWWLLWLDWWWWWDWDLDDL,2025-07-27 14:09:22.444943
169,78,2022,Eintracht Frankfurt,34,17,17,13,9,4,11,5,6,10,3,7,58,35,23,1.7,2.1,1.4,52,18,34,1.5,1.1,2.0,6,6,0,5,1,4,LDDWWLWWLWWLWWDWDDWLWLDDLDLDLDLWDW,2025-07-27 14:09:22.445021
170,78,2022,FC Augsburg,34,17,17,9,6,3,7,4,3,18,7,11,42,16,26,1.2,0.9,1.5,63,24,39,1.9,1.4,2.3,6,5,1,7,4,3,LWLLLWWWDLDLLDLLWLWLWLWLDDLLDDWLLL,2025-07-27 14:09:22.445104
172,78,2022,VfB Stuttgart,36,18,18,9,6,3,12,6,6,15,6,9,51,26,25,1.4,1.4,1.4,58,22,36,1.6,1.2,2.0,3,2,1,8,4,4,DDLDDDLLLWLWLWLDDLLLWLLDLLWDDWLDWDWW,2025-07-27 14:09:22.445184
173,78,2022,RB Leipzig,34,17,17,20,13,7,6,2,4,8,2,6,64,38,26,1.9,2.2,1.5,41,18,23,1.2,1.1,1.4,10,6,4,6,1,5,DDLWLWLWDWDWWWWDWWDLWWLWLLWWLWWWWW,2025-07-27 14:09:22.445263
174,78,2022,FC Schalke 04,34,17,17,7,5,2,10,5,5,17,7,10,35,23,12,1.0,1.4,0.7,71,36,35,2.1,2.1,2.1,7,3,4,15,6,9,LDDLDWLLLLLLLWLLLDDDDWWDDLLWLWWLDL,2025-07-27 14:09:22.445320
175,78,2022,Hamburger SV,2,1,1,0,0,0,0,0,0,2,1,1,1,1,0,0.5,1.0,0.0,6,3,3,3.0,3.0,3.0,0,0,0,1,0,1,LL,2025-07-27 14:09:22.445390
176,78,2022,VfL Bochum,34,17,17,10,8,2,5,2,3,19,7,12,40,28,12,1.2,1.6,0.7,72,32,40,2.1,1.9,2.4,5,3,2,12,4,8,LLLLLLDLWLWLLWWWLLWLLLLWWDLDLDLWDW,2025-07-27 14:09:22.445451
182,78,2022,Union Berlin,34,17,17,18,11,7,8,6,2,8,0,8,51,30,21,1.5,1.8,1.2,38,11,27,1.1,0.6,1.6,13,8,5,8,3,5,WDWWDWWLWWLWLDLWWWWWDLDDWWLDWDLWLW,2025-07-27 14:09:22.445505
192,78,2022,1.FC Köln,34,17,17,10,6,4,12,5,7,12,6,6,49,28,21,1.4,1.6,1.2,54,20,34,1.6,1.2,2.0,6,4,2,13,7,6,WDDDWLDWLWLDLLLWDDDWLLDLLDWDWLWWDL,2025-07-27 14:09:22.445574
157,78,2023,Bayern München,34,17,17,23,14,9,3,1,2,8,2,6,94,53,41,2.8,3.1,2.4,45,12,33,1.3,0.7,1.9,11,8,3,3,2,1,WWWDWDWWWWWWLWWWLWWWLLWDWWLLWWWLWL,2025-07-27 14:09:22.445652
158,78,2023,Fortuna Düsseldorf,2,1,1,1,0,1,0,0,0,1,1,0,3,0,3,1.5,0.0,3.0,3,3,0,1.5,3.0,0.0,1,0,1,1,1,0,WL,2025-07-27 14:09:22.445728
160,78,2023,SC Freiburg,34,17,17,11,5,6,9,7,2,14,5,9,45,28,17,1.3,1.6,1.0,58,30,28,1.7,1.8,1.6,10,4,6,6,1,5,WWLLDWLWLDLDWWWLDWLLLDLDWLWLWDLDDL,2025-07-27 14:09:22.445805
161,78,2023,VfL Wolfsburg,34,17,17,10,6,4,7,4,3,17,7,10,41,25,16,1.2,1.5,0.9,56,25,31,1.6,1.5,1.8,6,4,2,7,1,6,WWLWLWLLLDLWLLWLDDDDLDDLLLWLLWWWLL,2025-07-27 14:09:22.445887
162,78,2023,Werder Bremen,34,17,17,11,7,4,9,4,5,14,6,8,48,29,19,1.4,1.7,1.1,54,26,28,1.6,1.5,1.6,7,3,4,7,3,4,LLWLWLLLWDDLLWDDDWWWLWDLLLLDLWWDDW,2025-07-27 14:09:22.445966
163,78,2023,Borussia Mönchengladbach,34,17,17,7,5,2,13,6,7,14,6,8,56,27,29,1.6,1.6,1.7,67,26,41,2.0,1.5,2.4,4,3,1,8,5,3,DLLDLWDLWDWLWLDLWLDLDLWDDDLWLLDDDL,2025-07-27 14:09:22.446045
164,78,2023,FSV Mainz 05,34,17,17,7,6,1,14,5,9,13,6,7,39,23,16,1.1,1.4,0.9,51,18,33,1.5,1.1,1.9,8,5,3,9,4,5,LDLLLLDLDWDDLDLDDLLDLWLDLWDWWDDDWW,2025-07-27 14:09:22.446124
165,78,2023,Borussia Dortmund,34,17,17,18,10,8,9,3,6,7,4,3,68,37,31,2.0,2.2,1.8,43,22,21,1.3,1.3,1.2,10,5,5,4,2,2,WDDWWWWWDLLWDLDDWWWDWDLWWWWLWDLWLW,2025-07-27 14:09:22.446203
167,78,2023,1899 Hoffenheim,34,17,17,13,6,7,7,5,2,14,6,8,66,31,35,1.9,1.8,2.1,66,31,35,1.9,1.8,2.1,2,0,2,3,2,1,LWWWWLWLWLDDLWLDLLDDDLWWLLLWLWLDWW,2025-07-27 14:09:22.446279
168,78,2023,Bayer Leverkusen,34,17,17,28,14,14,6,3,3,0,0,0,89,47,42,2.6,2.8,2.5,24,11,13,0.7,0.6,0.8,16,8,8,1,1,0,WWWDWWWWWWWWDDWWWWDWWWWWWWWWWDDWWW,2025-07-27 14:09:22.446355
169,78,2023,Eintracht Frankfurt,34,17,17,11,7,4,14,8,6,9,2,7,51,29,22,1.5,1.7,1.3,50,21,29,1.5,1.2,1.7,7,5,2,6,2,4,WDDDDLWWDWDLLWLWWDWLDDDWWLDDLWLLDD,2025-07-27 14:09:22.446434
170,78,2023,FC Augsburg,34,17,17,10,6,4,9,6,3,15,5,10,50,26,24,1.5,1.5,1.4,60,26,34,1.8,1.5,2.0,3,2,1,8,3,5,DLDLWLLWWDDDWLDLLWLDDLWWWWDLWLLLLL,2025-07-27 14:09:22.446511
172,78,2023,VfB Stuttgart,34,17,17,23,13,10,4,3,1,7,1,6,78,50,28,2.3,2.9,1.6,39,15,24,1.1,0.9,1.4,12,7,5,3,0,3,WLWWWWWWLLWWWDLWLLWWWWDWWWDWWLDWWW,2025-07-27 14:09:22.446589
173,78,2023,RB Leipzig,34,17,17,19,11,8,8,4,4,7,2,5,77,40,37,2.3,2.4,2.2,39,12,27,1.1,0.7,1.6,10,8,2,4,3,1,LWWWWDDWWLWLWWWDLLLWDWLWWWDWWWWDDD,2025-07-27 14:09:22.446667
176,78,2023,VfL Bochum,36,18,18,8,5,3,12,8,4,16,5,11,45,26,19,1.3,1.4,1.1,77,32,45,2.1,1.8,2.5,5,2,3,9,2,7,LDDDLLDLDWDDWLWLDWLDDWLLLLDLDLWWLLLW,2025-07-27 14:09:22.446748
180,78,2023,1. FC Heidenheim,34,17,17,10,7,3,12,5,7,12,5,7,50,30,20,1.5,1.8,1.2,55,26,29,1.6,1.5,1.7,6,4,2,5,2,3,LLDWLWLLLWLDLWWWDDDDWLDLLDDWDLWDDW,2025-07-27 14:09:22.446820
181,78,2023,SV Darmstadt 98,34,17,17,3,1,2,8,3,5,23,13,10,30,15,15,0.9,0.9,0.9,86,44,42,2.5,2.6,2.5,3,1,2,17,9,8,LLLDLWWLLLDDLLLDLDLLDLDLLLDLLWLLLL,2025-07-27 14:09:22.446872
182,78,2023,Union Berlin,34,17,17,9,7,2,6,2,4,19,8,11,33,22,11,1.0,1.3,0.6,58,30,28,1.7,1.8,1.6,7,3,4,17,6,11,WWLLLLLLLLLDWLWDLWLDWWDLLWDLLLDLLW,2025-07-27 14:09:22.446927
192,78,2023,1.FC Köln,34,17,17,5,4,1,12,4,8,17,9,8,28,15,13,0.8,0.9,0.8,60,28,32,1.8,1.6,1.9,4,3,1,14,8,6,LLDLLLLWLDDLWDLLDLDWDLDLDLDWLLDDWL,2025-07-27 14:09:22.447016
157,78,2024,Bayern München,34,17,17,25,14,11,7,2,5,2,1,1,99,53,46,2.9,3.1,2.7,32,16,16,0.9,0.9,0.9,16,9,7,1,0,1,WWWWDDWWWWWDWLWWWWWWWDWWLDWWDWWDWW,2025-07-27 14:09:22.447101
160,78,2024,SC Freiburg,34,17,17,16,9,7,7,3,4,11,5,6,49,32,17,1.4,1.9,1.0,53,26,27,1.6,1.5,1.6,11,4,7,8,3,5,WLWWLWWLDDLWDWLWLLLWWWWDDDLLWWWDWL,2025-07-27 14:09:22.447187
161,78,2024,VfL Wolfsburg,34,17,17,11,3,8,10,7,3,13,7,6,56,27,29,1.6,1.6,1.7,54,30,24,1.6,1.8,1.4,6,2,4,7,3,4,LWLLDWLDDWWWWLLWWLDDDWDWDLLLLDLLDW,2025-07-27 14:09:22.447265
162,78,2024,Werder Bremen,34,17,17,14,5,9,9,6,3,11,6,5,54,21,33,1.6,1.2,1.9,57,26,31,1.7,1.5,1.8,10,6,4,9,6,3,DDWLWLWDLWLDWWWLDLDWLLLLWLWWWWDDDW,2025-07-27 14:09:22.447345
163,78,2024,Borussia Mönchengladbach,34,17,17,13,7,6,6,3,3,15,7,8,55,29,26,1.6,1.7,1.5,57,26,31,1.7,1.5,1.8,7,4,3,6,3,3,LWLLWLWDWDWLDWWLLLWWDWLWLWWDLLLDLL,2025-07-27 14:09:22.447422
164,78,2024,FSV Mainz 05,34,17,17,14,6,8,10,8,2,10,3,7,55,24,31,1.6,1.4,1.8,43,18,25,1.3,1.1,1.5,9,5,4,8,3,5,DDLWLWLDDWWWLWWWLLWLDWWWWDLDLDLDWD,2025-07-27 14:09:22.447501
165,78,2024,Borussia Dortmund,34,17,17,17,11,6,6,3,3,11,3,8,71,44,27,2.1,2.6,1.6,51,19,32,1.5,1.1,1.9,7,5,2,5,1,4,WDWLWLWLWLWDDDWLLLDWLLWWLLWWDWWWWW,2025-07-27 14:09:22.447579
167,78,2024,1899 Hoffenheim,34,17,17,7,4,3,11,5,6,16,8,8,46,25,21,1.4,1.5,1.2,68,36,32,2.0,2.1,1.9,4,1,3,9,4,5,WLLLLDWDLDWLDDLLLWDLLWDWDLDLWLLDDL,2025-07-27 14:09:22.447658
168,78,2024,Bayer Leverkusen,34,17,17,19,10,9,12,4,8,3,3,0,72,36,36,2.1,2.1,2.1,43,22,21,1.3,1.3,1.2,9,5,4,5,4,1,WLWWDDWDDDWWWWWWWWDWDDWWLWWWDDWDLD,2025-07-27 14:09:22.447773
169,78,2024,Eintracht Frankfurt,34,17,17,17,10,7,9,4,5,8,3,5,68,41,27,2.0,2.4,1.6,46,22,24,1.4,1.3,1.4,9,6,3,4,0,4,LWWWWDLDWWWWDLLWWWDDDWLLLWWLWDWDDW,2025-07-27 14:09:22.447846
170,78,2024,FC Augsburg,34,17,17,11,6,5,10,5,5,13,6,7,35,18,17,1.0,1.1,1.0,51,20,31,1.5,1.2,1.8,11,6,5,12,6,6,DLWLLWLWDDLWDLLLWWWDDDWDWWDLWDLLLL,2025-07-27 14:09:22.447911
172,78,2024,VfB Stuttgart,34,17,17,14,7,7,8,2,6,12,8,4,64,35,29,1.9,2.1,1.7,53,27,26,1.6,1.6,1.5,7,3,4,6,2,4,LDWWDDLWDLWDWWLWWWLLWLDLDLLWLDLWWW,2025-07-27 14:09:22.447962
173,78,2024,RB Leipzig,34,17,17,13,8,5,12,6,6,9,3,6,53,33,20,1.6,1.9,1.2,48,23,25,1.4,1.4,1.5,14,6,8,9,2,7,WWDDWWWWLDLLWWLWLDDDWDDLDWLWWDLDDL,2025-07-27 14:09:22.448024
176,78,2024,VfL Bochum,34,17,17,5,3,2,8,4,4,21,10,11,32,16,16,0.9,0.9,0.9,68,33,35,2.0,1.9,2.1,5,3,2,13,6,7,LLLDLLLLLDLLLDWLWDLLDWDLWLLLLLDDLW,2025-07-27 14:09:22.448081
180,78,2024,1. FC Heidenheim,36,18,18,9,3,6,6,3,3,21,12,9,41,15,26,1.1,0.8,1.4,67,35,32,1.9,1.9,1.8,9,4,5,14,10,4,WWLLWLLDLLLLLLLWDLLLLLDLDWWLLLWDWLDW,2025-07-27 14:09:22.448141
182,78,2024,Union Berlin,34,17,17,10,5,5,11,7,4,13,5,8,36,19,17,1.1,1.1,1.0,50,22,28,1.5,1.3,1.6,8,4,4,13,5,8,DWDWLWWDLDLLLDLLLWLDWLLLWDWWDDDDLW,2025-07-27 14:09:22.448204
186,78,2024,FC St. Pauli,34,17,17,8,3,5,8,5,3,18,9,9,28,10,18,0.8,0.6,1.1,41,19,22,1.2,1.1,1.3,9,4,5,17,11,6,LLLDWLLDWLLWLLWLLWWDLLLLDWLDWDDLDL,2025-07-27 14:09:22.448269
191,78,2024,Holstein Kiel,34,17,17,6,4,2,7,2,5,21,11,10,49,24,25,1.4,1.4,1.5,80,41,39,2.4,2.4,2.3,2,1,1,7,6,1,LLLDLDLLWLLLLLWLWLDLDLLWDLLDLDWWLL,2025-07-27 14:09:22.448328
1660,78,2024,SV Elversberg,2,1,1,0,0,0,1,0,1,1,1,0,3,1,2,1.5,1.0,2.0,4,2,2,2.0,2.0,2.0,0,0,0,0,0,0,DL,2025-07-27 14:09:22.448388
1063,61,2020,Saint Etienne,38,19,19,12,5,7,10,6,4,16,8,8,42,20,22,1.1,1.1,1.2,54,29,25,1.4,1.5,1.3,12,5,7,11,6,5,WWWDLLLLLLLDDDWDDDLLLWDWWDLLWLWWLLWWDL,2025-07-27 14:09:22.448446
77,61,2020,Angers,38,19,19,12,6,6,8,3,5,18,10,8,40,20,20,1.1,1.1,1.1,58,27,31,1.5,1.4,1.6,9,3,6,16,8,8,WLWLWLDWLWLWWDLDWWLLLWDLLDDWLDDLLLLWLL,2025-07-27 14:09:22.448530
78,61,2020,Bordeaux,38,19,19,13,7,6,6,4,2,19,8,11,42,19,23,1.1,1.0,1.2,56,21,35,1.5,1.1,1.8,14,9,5,12,8,4,DWDLDWLWLLWDWLLWLDWWWLLLDLLLWLLLLLWLWW,2025-07-27 14:09:22.448586
79,61,2020,Lille,38,19,19,24,10,14,11,7,4,3,2,1,64,28,36,1.7,1.5,1.9,23,11,12,0.6,0.6,0.6,21,10,11,4,3,1,DWWDWWWDDLWDWWWDWLWWWWWWDWDWDLWWDWWWDW,2025-07-27 14:09:22.448644
80,61,2020,Lyon,38,19,19,22,11,11,10,3,7,6,5,1,81,42,39,2.1,2.2,2.1,43,23,20,1.1,1.2,1.1,11,6,5,3,2,1,WDLDDDWWDWWWWWDWWWDLWWWWLWDWDLDWWLWWWL,2025-07-27 14:09:22.448730
81,61,2020,Marseille,38,19,19,16,10,6,12,5,7,10,4,6,54,32,22,1.4,1.7,1.2,47,23,24,1.2,1.2,1.3,8,2,6,8,3,5,WWLDDDWWWWWWLDLWDLLLDLDWDDLWWLWDWWDLWD,2025-07-27 14:09:22.448810
82,61,2020,Montpellier,38,19,19,14,7,7,12,4,8,12,8,4,60,34,26,1.6,1.8,1.4,62,35,27,1.6,1.8,1.4,5,1,4,6,4,2,LWWWDLDLWWWWLWLDLLDLLLDWWWDDDWDDDLLWDW,2025-07-27 14:09:22.448892
83,61,2020,Nantes,40,20,20,10,3,7,13,8,5,17,9,8,49,21,28,1.2,1.1,1.4,57,30,27,1.4,1.5,1.4,5,2,3,10,5,5,DWLDLLWLWDDLLDLDLDDDLLDLWDDLWDLLLWWWWLWL,2025-07-27 14:09:22.448975
84,61,2020,Nice,38,19,19,15,7,8,7,3,4,16,9,7,50,25,25,1.3,1.3,1.3,53,30,23,1.4,1.6,1.2,9,3,6,11,6,5,WWLLDWWDWLLDLWLDLDLWLLWLLLWWDWWDLWLWLW,2025-07-27 14:09:22.449059
85,61,2020,Paris Saint Germain,38,19,19,26,13,13,4,1,3,8,5,3,86,44,42,2.3,2.3,2.2,28,14,14,0.7,0.7,0.7,19,9,10,6,4,2,LLWWWWWWWWLDWLWDWDWWWLWWWLWWLWLWWWWDWW,2025-07-27 14:09:22.449140
89,61,2020,Dijon,38,19,19,4,1,3,9,6,3,25,12,13,25,8,17,0.7,0.4,0.9,73,31,42,1.9,1.6,2.2,6,4,2,21,13,8,LLLLDLDLDDLWDDLLWDDDLLLLLLLLLLLLWLLLLW,2025-07-27 14:09:22.449220
91,61,2020,Monaco,38,19,19,24,12,12,6,5,1,8,2,6,76,43,33,2.0,2.3,1.7,42,21,21,1.1,1.1,1.1,15,7,8,5,2,3,DWWLWLDLWWWWLLLWDWWWWWWWDWWLDWWWWWLWWD,2025-07-27 14:09:22.449300
92,61,2020,Nimes,38,19,19,9,3,6,8,5,3,21,11,10,40,22,18,1.1,1.2,0.9,71,39,32,1.9,2.1,1.7,8,3,5,13,6,7,WLLDDWLLLLWLLLLDLLLWLLLWWWDLDWLDDLDWLL,2025-07-27 14:09:22.449384
93,61,2020,Reims,38,19,19,9,4,5,15,8,7,14,7,7,42,16,26,1.1,0.8,1.4,50,21,29,1.3,1.1,1.5,10,6,4,14,9,5,DLLLLDLWWDLLDLWDWDWLWWDLDDDWDWDDDLDLLL,2025-07-27 14:09:22.449452
94,61,2020,Rennes,38,19,19,16,9,7,10,4,6,12,6,6,52,26,26,1.4,1.4,1.4,40,21,19,1.1,1.1,1.0,10,4,6,10,4,6,DWWWWDDLWLLDLWWWWDDWLDDLLLLLWWDWWWLDLW,2025-07-27 14:09:22.449515
95,61,2020,Strasbourg,38,19,19,11,4,7,9,5,4,18,10,8,49,21,28,1.3,1.1,1.5,58,29,29,1.5,1.5,1.5,10,5,5,10,6,4,LLLWLLLWLLLDWDWLLWWWDLDLWDDWLLWLDLDLWD,2025-07-27 14:09:22.449594
96,61,2020,Toulouse,2,1,1,1,0,1,0,0,0,1,1,0,2,1,1,1.0,1.0,1.0,2,2,0,1.0,2.0,0.0,1,0,1,0,0,0,LW,2025-07-27 14:09:22.449676
97,61,2020,Lorient,38,19,19,11,10,1,9,2,7,18,7,11,50,31,19,1.3,1.6,1.0,68,29,39,1.8,1.5,2.1,5,4,1,10,4,6,WLLLDLWLDLLLLWLLDLLWWDWDLLWDDDWLLWWLWD,2025-07-27 14:09:22.449758
106,61,2020,Stade Brestois 29,38,19,19,11,8,3,8,4,4,19,7,12,50,32,18,1.3,1.7,0.9,66,33,33,1.7,1.7,1.7,7,3,4,11,3,8,LLWWLWLLLWWWLWDDLWLLLLDWDLLWLDLDDWLLDL,2025-07-27 14:09:22.449839
112,61,2020,Metz,38,19,19,12,5,7,11,5,6,15,9,6,44,19,25,1.2,1.0,1.3,48,26,22,1.3,1.4,1.2,8,4,4,12,6,6,LLLWDWDWWDDLLDWWLDDWWWDLLWWLDLLLDLWLLD,2025-07-27 14:09:22.449935
116,61,2020,Lens,38,19,19,15,7,8,12,7,5,11,5,6,55,28,27,1.4,1.5,1.4,54,26,28,1.4,1.4,1.5,8,4,4,8,5,3,LWWWDWLDWDLWLWLWLLDWLWDDDWDWDWDWDWLLLD,2025-07-27 14:09:22.450014
1063,61,2021,Saint Etienne,40,20,20,7,4,3,13,7,6,20,9,11,44,25,19,1.1,1.3,1.0,79,39,40,2.0,2.0,2.0,4,1,3,9,3,6,DDDLLLLLDLDDWWLLLLLLLWWWDLWDDLLWDLLLLDDD,2025-07-27 14:09:22.450098
77,61,2021,Angers,38,19,19,10,8,2,11,2,9,17,9,8,44,23,21,1.2,1.2,1.1,55,23,32,1.4,1.2,1.7,8,6,2,11,6,5,WWDWDLDDWLDLDWDLWLLDWLLLLLLLWLDDLDLWLW,2025-07-27 14:09:22.450184
78,61,2021,Bordeaux,38,19,19,6,3,3,13,7,6,19,9,10,52,25,27,1.4,1.3,1.4,91,33,58,2.4,1.7,3.1,2,1,1,12,6,6,LDDLLWDDLDDWLDLLDWLLLWLLDDLLLDWLDLLLDW,2025-07-27 14:09:22.450254
79,61,2021,Lille,38,19,19,14,7,7,13,8,5,11,4,7,48,24,24,1.3,1.3,1.3,48,22,26,1.3,1.2,1.4,10,7,3,9,5,4,DLDWLLWWWLDLDDDWWDWDWLLWDWWDWDDLLWLLWD,2025-07-27 14:09:22.450317
80,61,2021,Lyon,38,19,19,17,11,6,11,5,6,10,3,7,66,42,24,1.7,2.2,1.3,51,25,26,1.3,1.3,1.4,9,3,6,5,1,4,DLDWWLWDDWLWLWLDDDDWWWLWDLWLDWDWLWWLWW,2025-07-27 14:09:22.450374
81,61,2021,Marseille,38,19,19,21,9,12,8,5,3,9,5,4,63,33,30,1.7,1.7,1.6,38,22,16,1.0,1.2,0.8,15,6,9,8,5,3,WDWWWDLLWDDWDWWLWDWDWLWWLDLWWWWLWWLWLW,2025-07-27 14:09:22.450461
82,61,2021,Montpellier,38,19,19,12,7,5,7,5,2,19,7,12,49,27,22,1.3,1.4,1.2,61,26,35,1.6,1.4,1.8,10,6,4,12,6,6,LDWLWDDLDWLWWLLWWWWLLWLLWLLDWLLDLLDLLL,2025-07-27 14:09:22.450554
83,61,2021,Nantes,38,19,19,15,11,4,10,4,6,13,4,9,55,33,22,1.4,1.7,1.2,48,20,28,1.3,1.1,1.5,8,5,3,10,5,5,DWLLLWWLWDWLDLDLWWWDLWLWWDWLLWDDLWDWLD,2025-07-27 14:09:22.450645
84,61,2021,Nice,38,19,19,20,10,10,7,4,3,11,5,6,52,27,25,1.4,1.4,1.3,36,21,15,0.9,1.1,0.8,14,5,9,13,5,8,DWWWDLWWLWDWLWLDLWWWWWLLWDWDLDLWLWWWLW,2025-07-27 14:09:22.450706
85,61,2021,Paris Saint Germain,38,19,19,26,16,10,8,3,5,4,0,4,90,49,41,2.4,2.6,2.2,36,12,24,0.9,0.6,1.3,13,9,4,5,1,4,WWWWWWWWLWDWWWWDDWDDWWWWLWLWLWWWWDDDWW,2025-07-27 14:09:22.450763
91,61,2021,Monaco,38,19,19,20,12,8,9,4,5,9,3,6,65,38,27,1.7,2.0,1.4,40,16,24,1.1,0.8,1.3,11,8,3,10,3,7,DLLWLDWWWLWLDDDWWLWDWLWDDLWLWWWWWWWWWD,2025-07-27 14:09:22.450820
93,61,2021,Reims,38,19,19,11,5,6,13,6,7,14,8,6,43,25,18,1.1,1.3,0.9,44,23,21,1.2,1.2,1.1,11,6,5,13,6,7,DDDLWDLWLDLLDDWWLWDDLLWLDWDWDLLDWLWLWL,2025-07-27 14:09:22.450872
94,61,2021,Rennes,38,19,19,20,14,6,6,1,5,12,4,8,82,50,32,2.2,2.6,1.7,40,13,27,1.1,0.7,1.4,14,11,3,5,1,4,DDWLLLWDWWWDWWWLWLLLWLWLWWWWWDWLLWWLWD,2025-07-27 14:09:22.450924
95,61,2021,Strasbourg,38,19,19,17,11,6,12,5,7,9,3,6,60,36,24,1.6,1.9,1.3,43,18,25,1.1,0.9,1.3,14,7,7,7,3,4,LLDWLWWLDWLWDDDWWLWWWLWWDDDWDWDDWLDWWL,2025-07-27 14:09:22.450975
97,61,2021,Lorient,38,19,19,8,6,2,12,6,6,18,7,11,35,20,15,0.9,1.1,0.8,63,22,41,1.7,1.2,2.2,11,6,5,13,6,7,DWLDWDWDDLDLLLLLLLDDLLWDLWLWDLWLWLLLDD,2025-07-27 14:09:22.451032
99,61,2021,Clermont Foot,38,19,19,9,4,5,9,6,3,20,9,11,38,22,16,1.0,1.2,0.8,69,33,36,1.8,1.7,1.9,8,3,5,12,4,8,WWDDLDLLDWLLLLLDLWDLLWWLWDLLLLLDWDLWLL,2025-07-27 14:09:22.451089
106,61,2021,Stade Brestois 29,38,19,19,13,7,6,9,4,5,16,8,8,49,28,21,1.3,1.5,1.1,57,29,28,1.5,1.5,1.5,7,5,2,7,4,3,DDLLDDLLLDDWWWWWWLDLLWLWDLWLLWDLWWWLLL,2025-07-27 14:09:22.451186
108,61,2021,Auxerre,2,1,1,0,0,0,2,1,1,0,0,0,2,1,1,1.0,1.0,1.0,2,1,1,1.0,1.0,1.0,0,0,0,0,0,0,DD,2025-07-27 14:09:22.451285
110,61,2021,Estac Troyes,38,19,19,9,5,4,11,7,4,18,7,11,37,19,18,1.0,1.0,0.9,53,19,34,1.4,1.0,1.8,9,6,3,9,4,5,LLDLWDLDLWWDLLLWLLDLWLDLLDWWDWLDLLWDLD,2025-07-27 14:09:22.451368
112,61,2021,Metz,38,19,19,6,3,3,13,7,6,19,9,10,35,21,14,0.9,1.1,0.7,69,31,38,1.8,1.6,2.0,8,3,5,16,7,9,DLDDLLLWLLLDDDWLLWDLWLDLDDLDLLLDLLDWWL,2025-07-27 14:09:22.451450
116,61,2021,Lens,38,19,19,17,9,8,11,7,4,10,3,7,62,35,27,1.6,1.8,1.4,48,20,28,1.3,1.1,1.5,8,6,2,8,3,5,DDWDWWLWWLWLWLDDDLLWWLLWDWLDWLWWWDDWWD,2025-07-27 14:09:22.451547
77,61,2022,Angers,38,19,19,4,3,1,6,3,3,28,13,15,33,20,13,0.9,1.1,0.7,81,36,45,2.1,1.9,2.4,4,2,2,13,3,10,DDLLLLWWLLLLLLLLLLLLLDDLLLLLDWLLLLLDWL,2025-07-27 14:09:22.451647
79,61,2022,Lille,38,19,19,19,13,6,10,4,6,9,2,7,65,40,25,1.7,2.1,1.3,44,25,19,1.2,1.3,1.0,10,5,5,7,1,6,WDLWLWLWLWWWLDWWDDWLDWWLWDDWWLWDWLDWWD,2025-07-27 14:09:22.451744
80,61,2022,Lyon,38,19,19,18,10,8,8,5,3,12,4,8,65,35,30,1.7,1.8,1.6,47,19,28,1.2,1.0,1.5,8,5,3,7,4,3,WWDWWLLLLDLWWLDWLDLWDWWLWDDDWWWLWWLWWL,2025-07-27 14:09:22.451816
81,61,2022,Marseille,38,19,19,22,10,12,7,4,3,9,5,4,67,35,32,1.8,1.8,1.7,40,24,16,1.1,1.3,0.8,10,2,8,5,2,3,WDWWWWWDWLLLDWWWWWWDWLWWLWDWDDWWWLWLLL,2025-07-27 14:09:22.451872
82,61,2022,Montpellier,38,19,19,15,7,8,5,3,2,18,9,9,65,29,36,1.7,1.5,1.9,62,29,33,1.6,1.5,1.7,11,4,7,5,2,3,WLLWWLLWLLLLLDDWLLLWLLWWDWWWDLLWWLDWLW,2025-07-27 14:09:22.451937
83,61,2022,Nantes,38,19,19,7,5,2,15,8,7,16,6,10,37,20,17,1.0,1.1,0.9,55,26,29,1.4,1.4,1.5,11,5,6,15,8,7,DDLWDLLDLLWDDLDDWDWDLWWLLLDDLDLDLLDLLW,2025-07-27 14:09:22.452015
84,61,2022,Nice,38,19,19,15,7,8,13,7,6,10,5,5,48,24,24,1.3,1.3,1.3,37,18,19,1.0,0.9,1.0,11,6,5,11,7,4,DDLLWLWLLWDDWWDDLWDWWWWDWDDDDLLLWWLDWW,2025-07-27 14:09:22.452076
85,61,2022,Paris Saint Germain,38,19,19,27,13,14,4,2,2,7,4,3,89,45,44,2.3,2.4,2.3,40,25,15,1.1,1.3,0.8,13,5,8,4,2,2,WWWDWWWWWDWWWWWWLWLDWWLWWWWLLWWWLWWWDL,2025-07-27 14:09:22.452134
91,61,2022,Monaco,38,19,19,19,9,10,8,3,5,11,7,4,70,37,33,1.8,1.9,1.7,58,33,25,1.5,1.7,1.3,9,3,6,6,4,2,WDLDLWWWWWDLWWLWWDWDWWWWLDLWWDWLLWDLLL,2025-07-27 14:09:22.452192
93,61,2022,Reims,38,19,19,12,8,4,15,6,9,11,5,6,45,28,17,1.2,1.5,0.9,45,23,22,1.2,1.2,1.2,14,7,7,12,4,8,LLDDWDLLDDDWDWDWDWDDWDWDWWWLWDLLLWLDLL,2025-07-27 14:09:22.452248
94,61,2022,Rennes,38,19,19,21,15,6,5,0,5,12,4,8,69,43,26,1.8,2.3,1.4,39,14,25,1.0,0.7,1.3,13,9,4,5,3,2,LDWLWDWDWWWWWDWLWLWLWLLWWLDWLLWLWLWWWW,2025-07-27 14:09:22.452302
95,61,2022,Strasbourg,38,19,19,9,5,4,13,7,6,16,7,9,51,25,26,1.3,1.3,1.4,59,26,33,1.6,1.4,1.7,6,4,2,6,3,3,LDDLDDDLLWLDDLDLLDWLLWLWDLDWLLWWLWWDDL,2025-07-27 14:09:22.452360
96,61,2022,Toulouse,38,19,19,13,6,7,9,6,3,16,7,9,51,27,24,1.3,1.4,1.3,57,27,30,1.5,1.4,1.6,9,3,6,11,6,5,DWDLLLWLWDWDLLLLWWDWWLWLLLWLLWLWLDDDDW,2025-07-27 14:09:22.452428
97,61,2022,Lorient,38,19,19,15,9,6,10,4,6,13,6,7,52,26,26,1.4,1.4,1.4,53,21,32,1.4,1.1,1.7,8,5,3,9,6,3,WDWLWWWWWWDDLLDLWDLWLDLWLDWDLDLLWWDLLW,2025-07-27 14:09:22.452487
98,61,2022,Ajaccio,38,19,19,7,4,3,5,3,2,26,12,14,23,10,13,0.6,0.5,0.7,74,30,44,1.9,1.6,2.3,6,5,1,22,13,9,LDLLLLLWLWDLLWDWLLLLWLLLWLLLLLLDLDLLLW,2025-07-27 14:09:22.452567
99,61,2022,Clermont Foot,38,19,19,17,9,8,8,3,5,13,7,6,45,20,25,1.2,1.1,1.3,49,28,21,1.3,1.5,1.1,10,5,5,10,6,4,LWWLLWDLWWDLDDLLWWWDDLLLDWLLWWWWWDWLWW,2025-07-27 14:09:22.452649
106,61,2022,Stade Brestois 29,38,19,19,11,7,4,11,5,6,16,7,9,44,24,20,1.2,1.3,1.1,54,26,28,1.4,1.4,1.5,9,6,3,10,4,6,LDWLLDLLDLLWDLWLLDDWDDLLLWLDWDWDWLWWWL,2025-07-27 14:09:22.452736
108,61,2022,Auxerre,38,19,19,8,5,3,11,7,4,19,7,12,35,18,17,0.9,0.9,0.9,63,28,35,1.7,1.5,1.8,7,5,2,11,5,6,LDWWLLLLDLDLWDLLLLLLLDDWWDDLWWWDLDLLDL,2025-07-27 14:09:22.452809
110,61,2022,Estac Troyes,38,19,19,4,1,3,12,11,1,22,7,15,45,19,26,1.2,1.0,1.4,81,30,51,2.1,1.6,2.7,1,1,0,11,6,5,LLLWWDLWDLDDLDLDWLLDLLLLLDLDLLLDLLLDLD,2025-07-27 14:09:22.452871
116,61,2022,Lens,38,19,19,25,17,8,9,1,8,4,1,3,68,41,27,1.8,2.2,1.4,29,13,16,0.8,0.7,0.8,15,8,7,5,1,4,WDWWWDWDWLWWWWWDWDWDLDLWDDWWWWLWWWWWWW,2025-07-27 14:09:22.452925
1063,61,2023,Saint Etienne,2,1,1,1,1,0,1,0,1,0,0,0,4,2,2,2.0,2.0,2.0,3,1,2,1.5,1.0,2.0,0,0,0,0,0,0,WD,2025-07-27 14:09:22.452981
79,61,2023,Lille,34,17,17,16,11,5,11,4,7,7,2,5,52,34,18,1.5,2.0,1.1,34,14,20,1.0,0.8,1.2,15,9,6,4,0,4,DWLWDLWDWWDDWWDDLWDWLWLWDDWWWLWLWD,2025-07-27 14:09:22.453039
80,61,2023,Lyon,34,17,17,16,7,9,5,4,1,13,6,7,49,25,24,1.4,1.5,1.4,55,29,26,1.6,1.7,1.5,10,5,5,7,3,4,LLDLDLLDLDWLLLWWWLLWWWWLWWDWWLWWWW,2025-07-27 14:09:22.453095
81,61,2023,Marseille,34,17,17,13,10,3,11,6,5,10,1,9,52,31,21,1.5,1.8,1.2,41,13,28,1.2,0.8,1.6,7,7,0,10,3,7,WDWDDLLWLDLDWWWWDDDLDLWWWLLLDDWWLW,2025-07-27 14:09:22.453149
82,61,2023,Montpellier,34,17,17,10,3,7,12,9,3,12,5,7,43,20,23,1.3,1.2,1.4,48,23,25,1.4,1.4,1.5,10,7,3,10,5,5,DWLLDDWLWLDLDLDWDLDLLWLDWLWWDWDWLD,2025-07-27 14:09:22.453205
83,61,2023,Nantes,34,17,17,9,3,6,6,3,3,19,11,8,30,17,13,0.9,1.0,0.8,55,30,25,1.6,1.8,1.5,8,3,5,14,7,7,LLDDWWLWWLLLDWLLLLDLWLWLLLWLWLDDLL,2025-07-27 14:09:22.453280
84,61,2023,Nice,34,17,17,15,9,6,10,4,6,9,4,5,40,21,19,1.2,1.2,1.1,29,11,18,0.9,0.6,1.1,17,11,6,9,3,6,DDDWWWDWWWWDWLWLWLWDLLDLLWLDWDWWLD,2025-07-27 14:09:22.453364
85,61,2023,Paris Saint Germain,34,17,17,22,9,13,10,6,4,2,2,0,81,42,39,2.4,2.5,2.3,33,22,11,1.0,1.3,0.6,12,4,8,3,1,2,DDWWLWDWWWWWWWWDWWDWWWDDDWWDWWDLWW,2025-07-27 14:09:22.453449
91,61,2023,Monaco,34,17,17,20,10,10,7,3,4,7,4,3,68,30,38,2.0,1.8,2.2,42,14,28,1.2,0.8,1.6,12,8,4,5,3,2,WWDWDLWWWLWDLWWLWLDDWLWDWDWWWWLWWW,2025-07-27 14:09:22.453530
93,61,2023,Reims,34,17,17,13,8,5,8,3,5,13,6,7,42,19,23,1.2,1.1,1.4,47,18,29,1.4,1.1,1.7,8,7,1,6,4,2,LWWDLWWLDWWLLWLLWWDLLDWLDWDDLLLDWW,2025-07-27 14:09:22.453610
94,61,2023,Rennes,34,17,17,12,7,5,10,4,6,12,6,6,53,34,19,1.6,2.0,1.1,46,26,20,1.4,1.5,1.2,7,2,5,8,1,7,WDDDDDWLLDLLWLLDWWWWWWDLDWLLLWLWDL,2025-07-27 14:09:22.453697
95,61,2023,Strasbourg,34,17,17,10,7,3,9,3,6,15,7,8,38,22,16,1.1,1.3,0.9,50,23,27,1.5,1.4,1.6,5,3,2,9,4,5,WLWLDWLLLDDDLDWWWDDLLLLDLWWDWLLLWL,2025-07-27 14:09:22.453778
96,61,2023,Toulouse,34,17,17,11,3,8,10,7,3,13,7,6,42,21,21,1.2,1.2,1.2,46,25,21,1.4,1.5,1.2,6,3,3,10,4,6,WDLDDLWDDLLDLDLDLWLWLWWWLLWDWDWLWL,2025-07-27 14:09:22.453858
97,61,2023,Lorient,34,17,17,7,4,3,8,4,4,19,9,10,43,26,17,1.3,1.5,1.0,66,30,36,1.9,1.8,2.1,4,3,1,14,5,9,DDWLDLLDWLDLLDLLLLDWWWLWLDLLLLLLLW,2025-07-27 14:09:22.453938
99,61,2023,Clermont Foot,34,17,17,5,3,2,10,5,5,19,9,10,26,14,12,0.8,0.8,0.7,60,27,33,1.8,1.6,1.9,5,3,2,16,8,8,LLLDLLDWLDWLDLDLLWDLDLDLLWLDDLWLLL,2025-07-27 14:09:22.454021
106,61,2023,Stade Brestois 29,34,17,17,17,8,9,10,7,3,7,2,5,53,25,28,1.6,1.5,1.6,34,14,20,1.0,0.8,1.2,15,9,6,9,4,5,WWLDWWDDLLLWWDWWWWDDDWWWLDWWLLWDDW,2025-07-27 14:09:22.454103
111,61,2023,Le Havre,34,17,17,7,6,1,11,2,9,16,9,7,34,18,16,1.0,1.1,0.9,45,19,26,1.3,1.1,1.5,7,4,3,16,8,8,DLDWDWLLDDWDDLLWLWDDLLLLWLLDLLDWLL,2025-07-27 14:09:22.454186
112,61,2023,Metz,36,18,18,8,3,5,6,4,2,22,11,11,38,19,19,1.1,1.1,1.1,62,29,33,1.7,1.6,1.8,6,2,4,11,7,4,LDWDWLLLLDDWWLLLLLLLDLLWWLLLWWLLLLLD,2025-07-27 14:09:22.454268
116,61,2023,Lens,34,17,17,14,9,5,9,4,5,11,4,7,45,27,18,1.3,1.6,1.1,37,18,19,1.1,1.1,1.1,14,6,8,7,2,5,LDLLLWWDDWDWWWDWLLWWWDLWWLLDLWLWDD,2025-07-27 14:09:22.454355
1063,61,2024,Saint Etienne,34,17,17,8,6,2,6,3,3,20,8,12,39,24,15,1.1,1.4,0.9,77,33,44,2.3,1.9,2.6,5,3,2,10,4,6,LLLWLDWLLWLWLLLWLDDLLLDLDWLLDWLLWL,2025-07-27 14:09:22.454438
77,61,2024,Angers,34,17,17,10,5,5,6,2,4,18,10,8,32,18,14,0.9,1.1,0.8,53,33,20,1.6,1.9,1.2,7,3,4,14,7,7,LLLDDLDDWWLLWLLWWWLDLWDLLLLLWLLWWL,2025-07-27 14:09:22.454517
79,61,2024,Lille,34,17,17,17,11,6,9,4,5,8,2,6,52,31,21,1.5,1.8,1.2,36,18,18,1.1,1.1,1.1,11,4,7,5,0,5,WWLLDWWDWDDWDWDDDWLWLWWLWLWLWWWDLW,2025-07-27 14:09:22.454602
80,61,2024,Lyon,34,17,17,17,11,6,6,2,4,11,4,7,65,37,28,1.9,2.2,1.6,46,21,25,1.4,1.2,1.5,10,6,4,5,2,3,LLWDLWWWDDWDWWLWLDDLWWLWWWLWWLWLLW,2025-07-27 14:09:22.454683
81,61,2024,Marseille,34,17,17,20,10,10,5,4,1,9,3,6,74,41,33,2.2,2.4,1.9,47,23,24,1.4,1.4,1.4,5,2,3,6,2,4,WDWWWLDWLWLWWWDWWDLWWWLWLLLWLWWDWW,2025-07-27 14:09:22.454765
82,61,2024,Montpellier,34,17,17,4,3,1,4,4,0,26,10,16,23,17,6,0.7,1.0,0.4,79,41,38,2.3,2.4,2.2,1,1,0,20,7,13,DLLLWLLLLLWLDLDLLWWLLLLLLLLLLLDLLL,2025-07-27 14:09:22.454829
83,61,2024,Nantes,34,17,17,8,5,3,12,6,6,14,6,8,39,19,20,1.1,1.1,1.2,52,18,34,1.5,1.1,2.0,6,5,1,8,5,3,DWWLDDLDLLLLDWLDDDDWLLWLLWLWLDDLDW,2025-07-27 14:09:22.454885
84,61,2024,Nice,34,17,17,17,11,6,9,4,5,8,2,6,66,38,28,1.9,2.2,1.6,41,15,26,1.2,0.9,1.5,8,6,2,4,1,3,LDWLWDDDWWDWLWDWWLWDWWWWLDLLDWWWLW,2025-07-27 14:09:22.454940
85,61,2024,Paris Saint Germain,34,17,17,26,14,12,6,2,4,2,1,1,92,45,47,2.7,2.6,2.8,35,16,19,1.0,0.9,1.1,7,4,3,1,0,1,WWWWDWDWWWWWDDWWWWDWWWWWWWWWWDLLWW,2025-07-27 14:09:22.454992
91,61,2024,Monaco,34,17,17,18,12,6,7,3,4,9,2,7,63,38,25,1.9,2.2,1.5,41,16,25,1.2,0.9,1.5,11,7,4,5,3,2,WWDWWWWDLLWWLWDLDLWWLWLWDWWLWDDWWL,2025-07-27 14:09:22.455056
93,61,2024,Reims,36,18,18,8,4,4,10,4,6,18,10,8,35,18,17,1.0,1.0,0.9,51,28,23,1.4,1.6,1.3,7,2,5,15,7,8,LDWWDWWLLLWDLDDLLDDLLLLLLDWLWWDLLLDL,2025-07-27 14:09:22.455142
94,61,2024,Rennes,34,17,17,13,9,4,2,1,1,19,7,12,51,25,26,1.5,1.5,1.5,50,17,33,1.5,1.0,1.9,11,8,3,7,3,4,WLLWDLLDWLLLWLWLLLLWWLWWLLWLWWLLWL,2025-07-27 14:09:22.455223
95,61,2024,Strasbourg,34,17,17,16,10,6,9,5,4,9,2,7,56,33,23,1.6,1.9,1.4,44,20,24,1.3,1.2,1.4,10,4,6,5,2,3,DWLDDWDLWLLLLDWWWDWLWWDWWWWWDDWWLL,2025-07-27 14:09:22.455304
96,61,2024,Toulouse,34,17,17,11,5,6,9,5,4,14,7,7,44,20,24,1.3,1.2,1.4,43,22,21,1.3,1.3,1.2,10,4,6,8,2,6,DDLWLLLDWWWLWLWWLDLDDLWWDLLLLLDWDW,2025-07-27 14:09:22.455390
106,61,2024,Stade Brestois 29,34,17,17,15,10,5,5,3,2,14,4,10,52,31,21,1.5,1.8,1.2,59,21,38,1.7,1.2,2.2,10,7,3,7,2,5,LLWLWLWDWLLLWLWLWWWLWDDLWDWWDLLWWL,2025-07-27 14:09:22.455470
108,61,2024,Auxerre,34,17,17,11,7,4,9,6,3,14,4,10,48,24,24,1.4,1.4,1.4,51,17,34,1.5,1.0,2.0,10,7,3,7,4,3,WLLLLWLWDWWWLDDLDLDLDDWLWDWWLLWLDL,2025-07-27 14:09:22.455547
111,61,2024,Le Havre,34,17,17,10,3,7,4,2,2,20,12,8,40,15,25,1.2,0.9,1.5,71,41,30,2.1,2.4,1.8,4,1,3,9,6,3,LWWLLLLLLWLWLLLLLDLDWLLWDLWWLLDWLW,2025-07-27 14:09:22.455634
112,61,2024,Metz,2,1,1,1,0,1,1,1,0,0,0,0,4,1,3,2.0,1.0,3.0,2,1,1,1.0,1.0,1.0,0,0,0,0,0,0,DW,2025-07-27 14:09:22.455711
116,61,2024,Lens,34,17,17,15,7,8,7,2,5,12,8,4,42,19,23,1.2,1.1,1.4,39,22,17,1.1,1.3,1.0,13,8,5,10,7,3,WWDDDDDWLLWLWWDLWLWWLLLLWWLWLWLWDW,2025-07-27 14:09:22.455791
413,88,2020,NEC Nijmegen,3,1,2,3,1,2,0,0,0,0,0,0,9,3,6,3.0,3.0,3.0,1,0,1,0.3,0.0,0.5,2,1,1,0,0,0,WWW,2025-07-27 14:09:22.455870
414,88,2020,Roda,2,0,2,1,0,1,0,0,0,1,0,1,3,0,3,1.5,0.0,1.5,5,0,5,2.5,0.0,2.5,0,0,0,1,0,1,WL,2025-07-27 14:09:22.455953
415,88,2020,Twente,34,17,17,10,4,6,11,6,5,13,7,6,48,23,25,1.4,1.4,1.5,50,25,25,1.5,1.5,1.5,6,2,4,9,4,5,WDWDWLWWDLWLWLWLDLDDLWDDDLDLLLLDLW,2025-07-27 14:09:22.456035
416,88,2020,FC Volendam,1,0,1,0,0,0,0,0,0,1,0,1,1,0,1,1.0,0.0,1.0,4,0,4,4.0,0.0,4.0,0,0,0,0,0,0,L,2025-07-27 14:09:22.456115
417,88,2020,Waalwijk,34,17,17,7,5,2,9,4,5,18,8,10,33,21,12,1.0,1.2,0.7,55,25,30,1.6,1.5,1.8,5,2,3,12,4,8,LLLWDDLLDWWLLLLDDLLDDWWDLLWLLLLDWL,2025-07-27 14:09:22.456193
419,88,2020,Almere City FC,1,1,0,0,0,0,0,0,0,1,1,0,0,0,0,0.0,0.0,0.0,4,4,0,4.0,4.0,0.0,0,0,0,1,1,0,L,2025-07-27 14:09:22.456285
426,88,2020,Sparta Rotterdam,35,17,18,13,6,7,8,4,4,14,7,7,49,30,19,1.4,1.8,1.1,50,27,23,1.4,1.6,1.3,10,6,4,11,5,6,LLLDDDLWWLWWLWLWLLDDLLLDWWDWLWWWDWL,2025-07-27 14:09:22.456365
193,88,2020,PEC Zwolle,34,17,17,9,6,3,11,6,5,14,5,9,44,19,25,1.3,1.1,1.5,53,18,35,1.6,1.1,2.1,7,5,2,10,7,3,LDWLDDLDDDWLDWDLLWDDDLLWLLWLWWLLLW,2025-07-27 14:09:22.456429
194,88,2020,Ajax,34,17,17,28,14,14,4,2,2,2,1,1,102,53,49,3.0,3.1,2.9,23,14,9,0.7,0.8,0.5,16,7,9,1,0,1,WWWLWWWWWWLWWDDWWWWWWWDWWWWWDWWWWW,2025-07-27 14:09:22.456500
195,88,2020,Willem II,34,17,17,8,6,2,7,2,5,19,9,10,40,22,18,1.2,1.3,1.1,68,33,35,2.0,1.9,2.1,6,3,3,11,4,7,LWDLLDLLWLLLLDLLDLLWLLDWDWDLLWLLWW,2025-07-27 14:09:22.456575
197,88,2020,PSV Eindhoven,34,17,17,21,13,8,9,3,6,4,1,3,74,39,35,2.2,2.3,2.1,35,13,22,1.0,0.8,1.3,12,8,4,1,0,1,WWDWWLWWDWDWWWDLWWWLWDWDWDLWWWDWWD,2025-07-27 14:09:22.456659
198,88,2020,ADO Den Haag,34,17,17,4,1,3,10,6,4,20,10,10,29,17,12,0.9,1.0,0.7,76,38,38,2.2,2.2,2.2,5,2,3,14,6,8,LLLWLDLLLDDDLLWLLDLDDLDDLLLLDLWWLL,2025-07-27 14:09:22.456740
199,88,2020,De Graafschap,1,1,0,0,0,0,0,0,0,1,1,0,2,2,0,2.0,2.0,0.0,3,3,0,3.0,3.0,0.0,0,0,0,0,0,0,L,2025-07-27 14:09:22.456825
200,88,2020,Vitesse,34,17,17,18,11,7,7,4,3,9,2,7,52,26,26,1.5,1.5,1.5,38,12,26,1.1,0.7,1.5,12,8,4,6,3,3,WWLWWWWWDWLDWLWWWWLDLLLWWWDWDDWLDL,2025-07-27 14:09:22.456893
201,88,2020,AZ Alkmaar,34,17,17,21,12,9,8,2,6,5,3,2,75,39,36,2.2,2.3,2.1,41,18,23,1.2,1.1,1.4,10,6,4,4,2,2,DDDDDWWWWLWWWDDWWWLLWWWWLWWWWLWWDW,2025-07-27 14:09:22.456949
202,88,2020,Groningen,35,17,18,14,7,7,8,6,2,13,4,9,40,17,23,1.1,1.0,1.3,38,13,25,1.1,0.8,1.4,12,9,3,11,5,6,LWLWDWWLDWWWWLDWDLWLWDDWLDLWLLLWDLL,2025-07-27 14:09:22.457016
203,88,2020,NAC Breda,3,2,1,1,1,0,1,0,1,1,1,0,6,5,1,2.0,2.5,1.0,4,3,1,1.3,1.5,1.0,0,0,0,0,0,0,WDL,2025-07-27 14:09:22.457099
204,88,2020,VVV Venlo,34,17,17,6,3,3,5,4,1,23,10,13,43,20,23,1.3,1.2,1.4,91,46,45,2.7,2.7,2.6,1,0,1,10,6,4,WDLLDLLWLDLLLLWWDWWLLLLLLLLLLLLDLL,2025-07-27 14:09:22.457178
205,88,2020,Fortuna Sittard,34,17,17,12,5,7,5,3,2,17,9,8,50,27,23,1.5,1.6,1.4,58,33,25,1.7,1.9,1.5,4,2,2,9,3,6,LLDLDLLDLLWWDWWLWLWWLWWLLWLLLWWLDL,2025-07-27 14:09:22.457251
206,88,2020,Heracles,34,17,17,12,8,4,8,4,4,14,5,9,42,29,13,1.2,1.7,0.8,53,16,37,1.6,0.9,2.2,9,6,3,11,3,8,WLDLLDWLLLDLWWLWLWDWWLLDWWDLWLWDDL,2025-07-27 14:09:22.457324
207,88,2020,Utrecht,36,18,18,14,7,7,14,7,7,8,4,4,53,28,25,1.5,1.6,1.4,43,25,18,1.2,1.4,1.0,9,3,6,7,2,5,DWDDWLLDDDLDWDDLWWWDWWLWLWWLDWWDDDWL,2025-07-27 14:09:22.457392
208,88,2020,Emmen,35,18,17,7,4,3,10,5,5,18,9,9,41,27,14,1.2,1.5,0.8,69,42,27,2.0,2.3,1.6,4,0,4,12,4,8,LLDDDLLLLLLDDLLLLDLLLLWWDDDWWWLLWWD,2025-07-27 14:09:22.457460
209,88,2020,Feyenoord,36,19,17,18,11,7,11,6,5,7,2,5,68,39,29,1.9,2.1,1.7,36,13,23,1.0,0.7,1.4,15,11,4,7,3,4,WDWWDDWWWDDWLWWWLLLWWDDLWDDWWDLLDWWW,2025-07-27 14:09:22.457537
210,88,2020,Heerenveen,34,17,17,9,6,3,12,5,7,13,6,7,43,22,21,1.3,1.3,1.2,49,18,31,1.4,1.1,1.8,10,8,2,7,4,3,WWWDLWWLDDDDLLLDDLWDWLDLWLDLWLDDLL,2025-07-27 14:09:22.457594
410,88,2021,GO Ahead Eagles,34,17,17,10,7,3,6,1,5,18,9,9,37,25,12,1.1,1.5,0.7,51,24,27,1.5,1.4,1.6,8,4,4,13,5,8,LLWLWLLDWWWDLWLDLLLDLLDWDLWWWLLLLL,2025-07-27 14:09:22.457646
413,88,2021,NEC Nijmegen,34,17,17,10,3,7,8,5,3,16,9,7,38,13,25,1.1,0.8,1.5,52,22,30,1.5,1.3,1.8,10,6,4,10,8,2,LWWDDLLWLWWDDLLLWWDLDWDLLLDWLLLWLL,2025-07-27 14:09:22.457705
414,88,2021,Roda,2,1,1,0,0,0,1,0,1,1,1,0,2,0,2,1.0,0.0,2.0,4,2,2,2.0,2.0,2.0,0,0,0,1,1,0,DL,2025-07-27 14:09:22.457765
415,88,2021,Twente,34,17,17,20,10,10,8,5,3,6,2,4,55,28,27,1.6,1.6,1.6,37,13,24,1.1,0.8,1.4,13,9,4,3,1,2,LDLWWWWDDLLWWDWWWDWWWLDWWWWDWWDLWW,2025-07-27 14:09:22.457821
417,88,2021,Waalwijk,34,17,17,9,6,3,11,3,8,14,8,6,40,17,23,1.2,1.0,1.4,51,25,26,1.5,1.5,1.5,6,4,2,8,5,3,WLDLDLLDDWLDLDWLLDWWLLDLLDWDLLWDWW,2025-07-27 14:09:22.457878
420,88,2021,Cambuur,34,17,17,11,5,6,6,3,3,17,9,8,53,29,24,1.6,1.7,1.4,70,35,35,2.1,2.1,2.1,4,1,3,6,0,6,LLWWLWWLLLWWWWLWLDDDLLLWLLLLLLDDDW,2025-07-27 14:09:22.457937
422,88,2021,FC Eindhoven,4,2,2,1,1,0,1,0,1,2,1,1,6,4,2,1.5,2.0,1.0,6,3,3,1.5,1.5,1.5,0,0,0,0,0,0,DWLL,2025-07-27 14:09:22.458016
426,88,2021,Sparta Rotterdam,34,17,17,8,4,4,11,7,4,15,6,9,30,16,14,0.9,0.9,0.8,48,21,27,1.4,1.2,1.6,7,3,4,13,5,8,LDLWDDLLDLLWLLLDDDDLLWLWDDLLWLDWWW,2025-07-27 14:09:22.458095
193,88,2021,PEC Zwolle,34,17,17,7,3,4,6,5,1,21,9,12,26,13,13,0.8,0.8,0.8,52,20,32,1.5,1.2,1.9,6,3,3,15,6,9,LLLLLDLLLWLLLDDLLLWWDWDLWLLLWWLDLL,2025-07-27 14:09:22.458173
194,88,2021,Ajax,34,17,17,26,14,12,5,1,4,3,2,1,98,62,36,2.9,3.6,2.1,19,8,11,0.6,0.5,0.6,22,12,10,3,2,1,WDWWWWWLWWDDWWWLWWWWWWWLWWWWWWWDWD,2025-07-27 14:09:22.458248
195,88,2021,Willem II,34,17,17,9,7,2,6,3,3,19,7,12,32,18,14,0.9,1.1,0.8,57,20,37,1.7,1.2,2.2,7,5,2,15,7,8,LWWDWWWLDDLLLLLLLLLLWLLLDLDLLWLWDW,2025-07-27 14:09:22.458337
196,88,2021,Excelsior,6,3,3,3,1,2,3,2,1,0,0,0,15,6,9,2.5,2.0,3.0,8,3,5,1.3,1.0,1.7,2,1,1,0,0,0,DWWWDD,2025-07-27 14:09:22.458417
197,88,2021,PSV Eindhoven,34,17,17,26,14,12,3,0,3,5,3,2,86,49,37,2.5,2.9,2.2,42,22,20,1.2,1.3,1.2,9,4,5,2,1,1,WWWWLWLWWLWWWDWWWWWLLWWWWWWDWWWDWW,2025-07-27 14:09:22.458493
198,88,2021,ADO Den Haag,6,3,3,4,2,2,2,1,1,0,0,0,13,8,5,2.2,2.7,1.7,9,6,3,1.5,2.0,1.0,0,0,0,0,0,0,WWWWDD,2025-07-27 14:09:22.458570
199,88,2021,De Graafschap,2,1,1,0,0,0,1,1,0,1,0,1,2,1,1,1.0,1.0,1.0,4,1,3,2.0,1.0,3.0,0,0,0,0,0,0,DL,2025-07-27 14:09:22.458652
200,88,2021,Vitesse,38,19,19,17,8,9,6,3,3,15,8,7,49,25,24,1.3,1.3,1.3,61,30,31,1.6,1.6,1.6,9,4,5,9,4,5,WLLWLWDWWLWWLDWWDWWLLLDWDLLWLLWLWDLWWL,2025-07-27 14:09:22.458729
201,88,2021,AZ Alkmaar,38,19,19,20,13,7,7,3,4,11,3,8,75,44,31,2.0,2.3,1.6,50,21,29,1.3,1.1,1.5,5,4,1,7,3,4,LWLLLWWWLWLDDWWWWWWDWWWWWLDWLWDDDLLWLW,2025-07-27 14:09:22.458809
202,88,2021,Groningen,34,17,17,9,4,5,9,6,3,16,7,9,41,18,23,1.2,1.1,1.4,55,21,34,1.6,1.2,2.0,4,3,1,9,5,4,WDLDLLLDDWLDWWDDLLLWWLDWDWWLLLLLLL,2025-07-27 14:09:22.458889
203,88,2021,NAC Breda,2,1,1,0,0,0,0,0,0,2,1,1,2,1,1,1.0,1.0,1.0,4,2,2,2.0,2.0,2.0,0,0,0,0,0,0,LL,2025-07-27 14:09:22.458966
205,88,2021,Fortuna Sittard,34,17,17,10,6,4,5,2,3,19,9,10,36,20,16,1.1,1.2,0.9,67,31,36,2.0,1.8,2.1,8,5,3,7,3,4,WDLLLDLWDLLLLLLWDLLLWWLLWLLDWWLWLW,2025-07-27 14:09:22.459042
206,88,2021,Heracles,36,18,18,9,7,2,7,5,2,20,6,14,34,23,11,0.9,1.3,0.6,55,24,31,1.5,1.3,1.7,8,5,3,14,5,9,LDLWLWWLLDLWLLLLWDDDLWLWLDLWLWDLLLLL,2025-07-27 14:09:22.459119
207,88,2021,Utrecht,36,18,18,13,9,4,11,6,5,12,3,9,54,35,19,1.5,1.9,1.1,50,21,29,1.4,1.2,1.6,8,4,4,8,3,5,WDWLDWWWLWWLLWLDDDLWWLDWDLLDDLWDDLWL,2025-07-27 14:09:22.459205
209,88,2021,Feyenoord,34,17,17,22,11,11,5,3,2,7,3,4,76,39,37,2.2,2.3,2.2,34,17,17,1.0,1.0,1.0,13,6,7,3,2,1,WWLWWWLDWWWWDWWDLWLWWWWLDWLWWWWDWL,2025-07-27 14:09:22.459268
210,88,2021,Heerenveen,36,18,18,12,7,5,8,3,5,16,8,8,40,26,14,1.1,1.4,0.8,54,28,26,1.5,1.6,1.4,8,3,5,11,5,6,WWLDWLLWLLLDWDWDWLLLLLLLDDWDWLDWLWWL,2025-07-27 14:09:22.459332
410,88,2022,GO Ahead Eagles,34,17,17,10,7,3,10,6,4,14,4,10,46,28,18,1.4,1.6,1.1,56,23,33,1.6,1.4,1.9,8,7,1,9,3,6,LLLLLWWDDDDWDDWDLLLWLWDLWDLLWWDLWL,2025-07-27 14:09:22.459389
412,88,2022,MVV,2,1,1,0,0,0,0,0,0,2,1,1,1,1,0,0.5,1.0,0.0,5,4,1,2.5,4.0,1.0,0,0,0,1,0,1,LL,2025-07-27 14:09:22.459446
413,88,2022,NEC Nijmegen,34,17,17,8,3,5,15,9,6,11,5,6,42,28,14,1.2,1.6,0.8,45,28,17,1.3,1.6,1.0,9,2,7,13,3,10,LWDDDDDDDLDLWWDDWLDLDWWLDWLDLWLLLD,2025-07-27 14:09:22.459495
415,88,2022,Twente,38,19,19,21,15,6,11,4,7,6,0,6,74,51,23,1.9,2.7,1.2,29,11,18,0.8,0.6,0.9,19,12,7,6,0,6,WWLWWDLWLWWWDDWDWDDDWLLDWWDWLDWWWWWWDW,2025-07-27 14:09:22.459565
416,88,2022,FC Volendam,34,17,17,10,9,1,6,1,5,18,7,11,42,29,13,1.2,1.7,0.8,71,32,39,2.1,1.9,2.3,5,3,2,9,2,7,DLWLLLDLLDLLLLWWLDWDLWLWLWDLLWLWLW,2025-07-27 14:09:22.459650
417,88,2022,Waalwijk,34,17,17,11,9,2,8,3,5,15,5,10,50,34,16,1.5,2.0,0.9,64,26,38,1.9,1.5,2.2,6,3,3,12,4,8,DDLDWLWDWDLLWLDLDWWDLWWLLWLWLLWLLL,2025-07-27 14:09:22.459713
419,88,2022,Almere City FC,6,3,3,3,2,1,2,1,1,1,0,1,9,6,3,1.5,2.0,1.0,5,2,3,0.8,0.7,1.0,1,1,0,1,0,1,LWDDWW,2025-07-27 14:09:22.459768
420,88,2022,Cambuur,34,17,17,5,3,2,4,0,4,25,14,11,26,14,12,0.8,0.8,0.7,69,33,36,2.0,1.9,2.1,7,2,5,20,11,9,LDWLLLLWDLLLLLLDLWLLDLLWLLLLLLLLLW,2025-07-27 14:09:22.459833
422,88,2022,FC Eindhoven,2,1,1,1,1,0,0,0,0,1,0,1,2,1,1,1.0,1.0,1.0,3,0,3,1.5,0.0,3.0,1,1,0,0,0,0,WL,2025-07-27 14:09:22.459895
426,88,2022,Sparta Rotterdam,38,19,19,18,10,8,9,3,6,11,6,5,63,33,30,1.7,1.7,1.6,41,20,21,1.1,1.1,1.1,14,5,9,11,5,6,DLLWWLWDWWLWWDDWWDDDWLLWWWLWWDLLWWWLDL,2025-07-27 14:09:22.459948
194,88,2022,Ajax,34,17,17,20,10,10,9,5,4,5,2,3,86,47,39,2.5,2.8,2.3,38,14,24,1.1,0.8,1.4,11,7,4,4,2,2,WWWWWWLDWWWLDDDDDDWWWWWWWLDWWLDWWL,2025-07-27 14:09:22.460000
195,88,2022,Willem II,2,1,1,0,0,0,1,1,0,1,0,1,4,2,2,2.0,2.0,2.0,5,2,3,2.5,2.0,3.0,0,0,0,0,0,0,LD,2025-07-27 14:09:22.460061
196,88,2022,Excelsior,34,17,17,9,8,1,5,2,3,20,7,13,32,22,10,0.9,1.3,0.6,71,26,45,2.1,1.5,2.6,8,5,3,16,6,10,WWLLLWLLDLWLLLWLWLLDLLLLLWDLWDLDWL,2025-07-27 14:09:22.460141
197,88,2022,PSV Eindhoven,34,17,17,23,14,9,6,2,4,5,1,4,89,54,35,2.6,3.2,2.1,40,14,26,1.2,0.8,1.5,11,8,3,4,2,2,WWWWLWWLWWLWWLDDWLWDWDWWWDWWWWWWDW,2025-07-27 14:09:22.460222
200,88,2022,Vitesse,34,17,17,10,5,5,10,6,4,14,6,8,45,24,21,1.3,1.4,1.2,50,25,25,1.5,1.5,1.5,9,6,3,11,5,6,LLLDWLDLLWWLDDDDLDWDWLLLLDLWWDLWWW,2025-07-27 14:09:22.460289
201,88,2022,AZ Alkmaar,34,17,17,20,9,11,7,5,2,7,3,4,68,36,32,2.0,2.1,1.9,35,20,15,1.0,1.2,0.9,12,4,8,2,1,1,WWWDWDWWWLLWLWDWWWDDWLWWWLDLWWDWWL,2025-07-27 14:09:22.460350
202,88,2022,Groningen,34,17,17,4,3,1,6,3,3,24,11,13,31,20,11,0.9,1.2,0.6,75,34,41,2.2,2.0,2.4,4,2,2,13,6,7,DLWDLWLLLLWDLLLLLLLDLDWLLLLLLLDLLL,2025-07-27 14:09:22.460411
203,88,2022,NAC Breda,4,2,2,2,1,1,0,0,0,2,1,1,6,2,4,1.5,1.0,2.0,5,2,3,1.3,1.0,1.5,1,1,0,1,0,1,WWLL,2025-07-27 14:09:22.460494
204,88,2022,VVV Venlo,4,2,2,1,1,0,3,1,2,0,0,0,7,4,3,1.8,2.0,1.5,6,3,3,1.5,1.5,1.5,0,0,0,0,0,0,WDDD,2025-07-27 14:09:22.460577
205,88,2022,Fortuna Sittard,34,17,17,10,5,5,6,4,2,18,8,10,39,21,18,1.1,1.2,1.1,62,28,34,1.8,1.6,2.0,7,6,1,10,6,4,LLLLLDWWWDDLLWLDLWWDWLLWLLWLLLWLLD,2025-07-27 14:09:22.460652
207,88,2022,Utrecht,36,18,18,16,8,8,9,5,4,11,5,6,57,21,36,1.6,1.2,2.0,52,17,35,1.4,0.9,1.9,13,8,5,6,4,2,DDLLWWDWLLWWWWDDLWDWLDWLDLDWWLWWLWLW,2025-07-27 14:09:22.460731
208,88,2022,Emmen,38,19,19,8,4,4,10,9,1,20,6,14,38,19,19,1.0,1.0,1.0,70,25,45,1.8,1.3,2.4,8,7,1,13,8,5,LDWLLLLDLDLDWDLDLWLDLDDLWLWDLWLLLLWWLL,2025-07-27 14:09:22.460814
209,88,2022,Feyenoord,34,17,17,25,12,13,7,4,3,2,1,1,81,37,44,2.4,2.2,2.6,30,10,20,0.9,0.6,1.2,13,8,5,2,2,0,WDWWWWLDWWDWWWDWDWDDWWWWWWWWWWWWWL,2025-07-27 14:09:22.460891
210,88,2022,Heerenveen,36,18,18,12,6,6,10,3,7,14,9,5,45,22,23,1.3,1.2,1.3,56,28,28,1.6,1.6,1.6,10,4,6,13,5,8,DDWWDLWDLDWLWWDLWLLLLWLDLWDWLLWDDWLL,2025-07-27 14:09:22.460980
409,88,2023,Dordrecht,2,1,1,0,0,0,1,0,1,1,1,0,2,0,2,1.0,0.0,2.0,3,1,2,1.5,1.0,2.0,0,0,0,1,1,0,DL,2025-07-27 14:09:22.461054
410,88,2023,GO Ahead Eagles,36,17,19,14,7,7,10,4,6,12,6,6,51,31,20,1.4,1.8,1.1,48,23,25,1.3,1.4,1.3,11,5,6,9,4,5,LWWDWLLWDDWWDLLDLWDWDWLWLLWDDLLDLWWW,2025-07-27 14:09:22.461131
413,88,2023,NEC Nijmegen,35,18,17,14,8,6,11,4,7,10,6,4,69,36,33,2.0,2.0,1.9,53,27,26,1.5,1.5,1.5,7,5,2,4,1,3,LLWDLWLDDDDDLWWWDWDWLDWWWLWDWDLWLWL,2025-07-27 14:09:22.461205
414,88,2023,Roda,2,1,1,0,0,0,0,0,0,2,1,1,1,0,1,0.5,0.0,1.0,8,5,3,4.0,5.0,3.0,0,0,0,1,1,0,LL,2025-07-27 14:09:22.461279
415,88,2023,Twente,34,17,17,21,14,7,6,1,5,7,2,5,69,40,29,2.0,2.4,1.7,36,17,19,1.1,1.0,1.1,10,6,4,6,2,4,WWWWLWWWDWDDLWWDWLDWWLWWWLWDWLWLWW,2025-07-27 14:09:22.461359
416,88,2023,FC Volendam,34,17,17,4,3,1,7,2,5,23,12,11,34,16,18,1.0,0.9,1.1,88,44,44,2.6,2.6,2.6,2,2,0,11,7,4,LLLLDLWLWLDLLLLWLDLLLDLLDLDDWLLLLL,2025-07-27 14:09:22.461433
417,88,2023,Waalwijk,34,17,17,7,4,3,8,6,2,19,7,12,38,20,18,1.1,1.2,1.1,56,25,31,1.6,1.5,1.8,5,3,2,11,4,7,LLLLWWLWLLLWDLLDLLDLWLLLWDDDLLDWDL,2025-07-27 14:09:22.461509
419,88,2023,Almere City FC,34,17,17,7,3,4,13,7,6,14,7,7,33,18,15,1.0,1.1,0.9,59,30,29,1.7,1.8,1.7,10,5,5,11,6,5,LLLLDLWWDDWDLLLWWDLWDWLDDDDDDLLDLL,2025-07-27 14:09:22.461585
426,88,2023,Sparta Rotterdam,35,17,18,14,6,8,7,5,2,14,6,8,52,25,27,1.5,1.5,1.5,51,25,26,1.5,1.5,1.4,8,4,4,7,3,4,WDWDLWLLDWLWLWLDWLDLLWLDLDWWLWWLWWL,2025-07-27 14:09:22.461664
193,88,2023,PEC Zwolle,34,17,17,9,5,4,9,3,6,16,9,7,45,19,26,1.3,1.1,1.5,67,31,36,2.0,1.8,2.1,5,3,2,6,3,3,LLWWDLLLWDWLLWLDDDWWDLLLDLLLWDWLDL,2025-07-27 14:09:22.461741
194,88,2023,Ajax,34,17,17,15,9,6,11,6,5,8,2,6,74,39,35,2.2,2.3,2.1,61,21,40,1.8,1.2,2.4,5,4,1,4,1,3,WDDLLLLLWWDWWWWDWWWDLDLWDDWDLWDWWD,2025-07-27 14:09:22.461818
196,88,2023,Excelsior,38,19,19,9,6,3,11,7,4,18,6,12,65,37,28,1.7,1.9,1.5,82,29,53,2.2,1.5,2.8,6,4,2,8,4,4,WDDLDWWDLLDDLDLDLWDLLLLLLDLLLWDLWLWWLW,2025-07-27 14:09:22.461892
197,88,2023,PSV Eindhoven,34,17,17,29,16,13,4,1,3,1,0,1,111,54,57,3.3,3.2,3.4,21,11,10,0.6,0.6,0.6,18,9,9,0,0,0,WWWWWWWWWWWWWWWWWDWDWWWDWWLWWWWWDW,2025-07-27 14:09:22.461983
198,88,2023,ADO Den Haag,4,2,2,1,0,1,1,1,0,2,1,1,7,3,4,1.8,1.5,2.0,13,4,9,3.3,2.0,4.5,0,0,0,0,0,0,WDLL,2025-07-27 14:09:22.462046
199,88,2023,De Graafschap,2,1,1,0,0,0,1,0,1,1,1,0,4,2,2,2.0,2.0,2.0,5,3,2,2.5,3.0,2.0,0,0,0,0,0,0,LD,2025-07-27 14:09:22.462101
200,88,2023,Vitesse,34,17,17,6,2,4,6,6,0,22,9,13,30,15,15,0.9,0.9,0.9,74,30,44,2.2,1.8,2.6,3,3,0,15,6,9,WLLLLLWDLDLLLLWLDLLLLDWLLDLLLLWLWD,2025-07-27 14:09:22.462170
201,88,2023,AZ Alkmaar,34,17,17,19,11,8,8,3,5,7,3,4,70,41,29,2.1,2.4,1.7,39,18,21,1.1,1.1,1.2,13,7,6,5,2,3,WWWWWDWWWDLWDLWLLDDLDWWDWWWLLWWWWD,2025-07-27 14:09:22.462244
203,88,2023,NAC Breda,6,3,3,4,2,2,1,1,0,1,0,1,19,10,9,3.2,3.3,3.0,8,4,4,1.3,1.3,1.3,2,0,2,0,0,0,WWDWWL,2025-07-27 14:09:22.462324
205,88,2023,Fortuna Sittard,34,17,17,9,7,2,11,6,5,14,4,10,37,27,10,1.1,1.6,0.6,56,20,36,1.6,1.2,2.1,9,4,5,16,6,10,DWDDWLLLLDLWLWWLLDWDLLWWDWLDLLLDDD,2025-07-27 14:09:22.462398
206,88,2023,Heracles,34,17,17,9,6,3,6,4,2,19,7,12,41,25,16,1.2,1.5,0.9,74,35,39,2.2,2.1,2.3,4,3,1,14,6,8,LWWLDDWLDLLLWLLLWDLLWLLDLWLWWLLLLD,2025-07-27 14:09:22.462477
207,88,2023,Utrecht,36,19,17,14,9,5,11,5,6,11,5,6,53,33,20,1.5,1.7,1.2,50,26,24,1.4,1.4,1.4,8,4,4,10,3,7,LLLLWLLLWDDDWDWDDDDWWWWLDWLWWWDWLDWL,2025-07-27 14:09:22.462553
208,88,2023,Emmen,4,2,2,1,0,1,2,1,1,1,1,0,4,2,2,1.0,1.0,1.0,6,5,1,1.5,2.5,0.5,1,0,1,1,1,0,DWDL,2025-07-27 14:09:22.462629
209,88,2023,Feyenoord,34,17,17,26,13,13,6,3,3,2,1,1,92,51,41,2.7,3.0,2.4,26,10,16,0.8,0.6,0.9,17,10,7,3,2,1,DDWWWWWWWLWWWLWWDWDWWWWDWWWDWWWWWW,2025-07-27 14:09:22.462706
210,88,2023,Heerenveen,34,17,17,10,6,4,7,3,4,17,8,9,53,30,23,1.6,1.8,1.4,70,36,34,2.1,2.1,2.0,7,4,3,8,3,5,WWLLLLLDLWLWWWLLDLDDWLWWLLDDLWLDLL,2025-07-27 14:09:22.462785
409,88,2024,Dordrecht,4,2,2,2,2,0,1,0,1,1,0,1,6,4,2,1.5,2.0,1.0,4,1,3,1.0,0.5,1.5,2,1,1,1,0,1,DWWL,2025-07-27 14:09:22.462862
410,88,2024,GO Ahead Eagles,34,17,17,14,10,4,9,4,5,11,3,8,57,32,25,1.7,1.9,1.5,55,22,33,1.6,1.3,1.9,9,6,3,7,2,5,LLWLWDWWLDDLWLWDWWWDLWLWWWLDDDLDWL,2025-07-27 14:09:22.462940
413,88,2024,NEC Nijmegen,35,17,18,12,6,6,7,6,1,16,5,11,53,36,17,1.5,2.1,0.9,49,24,25,1.4,1.4,1.4,10,4,6,9,0,9,LLWWLLDLWLWWLLLDLWWDLDLDLWDLWLDWWWL,2025-07-27 14:09:22.463019
415,88,2024,Twente,36,18,18,16,11,5,9,4,5,11,3,8,67,39,28,1.9,2.2,1.6,54,23,31,1.5,1.3,1.7,11,8,3,2,0,2,WDLDWWWLDWWDWWLWLWLDDWWDWLLDDLWWLLWL,2025-07-27 14:09:22.463098
417,88,2024,Waalwijk,34,17,17,6,5,1,7,3,4,21,9,12,44,25,19,1.3,1.5,1.1,74,31,43,2.2,1.8,2.5,4,4,0,11,6,5,LLLLLLLLDLWLDDLLDLDWWWLLLLDDLLLWLW,2025-07-27 14:09:22.463183
419,88,2024,Almere City FC,34,17,17,4,2,2,10,5,5,20,10,10,23,13,10,0.7,0.8,0.6,64,36,28,1.9,2.1,1.6,7,3,4,17,7,10,LLLDDLLLDWLLLLLLWDLLWDLLLDWDLLDLDD,2025-07-27 14:09:22.463260
420,88,2024,Cambuur,2,1,1,0,0,0,1,1,0,1,0,1,1,1,0,0.5,1.0,0.0,2,1,1,1.0,1.0,1.0,0,0,0,1,0,1,LD,2025-07-27 14:09:22.463338
421,88,2024,Den Bosch,4,2,2,1,1,0,2,1,1,1,0,1,3,1,2,0.8,0.5,1.0,3,0,3,0.8,0.0,1.5,2,2,0,1,1,0,WDDL,2025-07-27 14:09:22.463412
426,88,2024,Sparta Rotterdam,34,17,17,9,4,5,12,6,6,13,7,6,39,20,19,1.1,1.2,1.1,43,24,19,1.3,1.4,1.1,6,4,2,9,4,5,DDDWLWDLDLLLLLLDLDDWWLLWDDWWWDLWDL,2025-07-27 14:09:22.463485
427,88,2024,Telstar,6,3,3,4,2,2,2,1,1,0,0,0,10,6,4,1.7,2.0,1.3,4,3,1,0.7,1.0,0.3,3,1,2,1,0,1,WWDWDW,2025-07-27 14:09:22.463564
193,88,2024,PEC Zwolle,34,17,17,10,7,3,11,4,7,13,6,7,43,24,19,1.3,1.4,1.1,51,20,31,1.5,1.2,1.8,6,5,1,10,3,7,LLLWDLWDLLDWLWDLDLWWDLDLLDWDDLWDWW,2025-07-27 14:09:22.463645
194,88,2024,Ajax,34,17,17,24,13,11,6,3,3,4,1,3,67,38,29,2.0,2.2,1.7,32,14,18,0.9,0.8,1.1,16,8,8,2,1,1,WLWDWWWWWWDWWDLWWWWWWWWWWDWWWLDLDW,2025-07-27 14:09:22.463724
195,88,2024,Willem II,38,19,19,7,4,3,9,3,6,22,12,10,41,24,17,1.1,1.3,0.9,65,32,33,1.7,1.7,1.7,5,3,2,11,5,6,DWDLWLLWDLLWDLLWWLDLLDLLLLLLLLDLLDLWDL,2025-07-27 14:09:22.463802
197,88,2024,PSV Eindhoven,34,17,17,25,13,12,4,3,1,5,1,4,103,55,48,3.0,3.2,2.8,39,15,24,1.1,0.9,1.4,9,6,3,2,1,1,WWWWWWWWWWLWWWWLWDLWDDDLWWLWWWWWWW,2025-07-27 14:09:22.463882
198,88,2024,ADO Den Haag,2,1,1,0,0,0,0,0,0,2,1,1,0,0,0,0.0,0.0,0.0,3,1,2,1.5,1.0,2.0,0,0,0,2,1,1,LL,2025-07-27 14:09:22.463963
199,88,2024,De Graafschap,2,1,1,0,0,0,1,1,0,1,0,1,0,0,0,0.0,0.0,0.0,2,0,2,1.0,0.0,2.0,1,1,0,2,1,1,DL,2025-07-27 14:09:22.464040
201,88,2024,AZ Alkmaar,36,19,17,18,10,8,9,4,5,9,5,4,65,37,28,1.8,1.9,1.6,40,20,20,1.1,1.1,1.2,12,6,6,5,1,4,WWDWWWLLLDLLWWWWWDDLWWWLDDDLLDWWWDWW,2025-07-27 14:09:22.464125
202,88,2024,Groningen,34,17,17,10,8,2,9,6,3,15,3,12,40,27,13,1.2,1.6,0.8,53,14,39,1.6,0.8,2.3,7,7,0,12,5,7,WWDDDLLLLLLWLWDLDLWDLWWDWDLLLWWLDL,2025-07-27 14:09:22.464207
203,88,2024,NAC Breda,34,17,17,8,6,2,9,6,3,17,5,12,34,21,13,1.0,1.2,0.8,58,22,36,1.7,1.3,2.1,5,4,1,10,2,8,LWLLWLLWWWLLDWWLLLWLDLDLDDDLDDLLLD,2025-07-27 14:09:22.464290
205,88,2024,Fortuna Sittard,34,17,17,11,8,3,8,1,7,15,8,7,37,17,20,1.1,1.0,1.2,54,24,30,1.6,1.4,1.8,10,8,2,11,6,5,WWLLLLDWDWWLLDDWWLLLDLLWWLLDLWLWDD,2025-07-27 14:09:22.464367
206,88,2024,Heracles,34,17,17,9,6,3,11,7,4,14,4,10,42,29,13,1.2,1.7,0.8,63,27,36,1.9,1.6,2.1,6,3,3,9,1,8,DLDLDWWLLLWLDLDLDWDDDWLWLDWDWLLWLL,2025-07-27 14:09:22.464432
207,88,2024,Utrecht,34,17,17,18,9,9,10,3,7,6,5,1,62,28,34,1.8,1.6,2.0,45,24,21,1.3,1.4,1.2,9,6,3,6,4,2,WDWWWWWWLWWWLDWDLWDDDLDWWLWDWWWLDD,2025-07-27 14:09:22.464511
209,88,2024,Feyenoord,34,17,17,20,11,9,8,3,5,6,3,3,76,38,38,2.2,2.2,2.2,38,18,20,1.1,1.1,1.2,10,6,4,5,2,3,DWDDWDWWWLWWWDWWLLDLWDWDWWWWWWWLWL,2025-07-27 14:09:22.464590
210,88,2024,Heerenveen,35,17,18,12,10,2,7,6,1,16,1,15,43,30,13,1.2,1.8,0.7,61,15,46,1.7,0.9,2.6,6,6,0,10,1,9,LDWLLWLDLWLWLDWWLWLLDDDWLDLWLWWLLWL,2025-07-27 14:09:22.464669
211,94,2020,Benfica,34,17,17,23,12,11,7,3,4,4,2,2,69,31,38,2.0,1.8,2.2,27,15,12,0.8,0.9,0.7,15,8,7,4,1,3,WWWWWLLWWWWDWDDLDWDDWWWWWWLWWWDWWW,2025-07-27 14:09:22.464749
212,94,2020,FC Porto,34,17,17,24,13,11,8,3,5,2,1,1,74,40,34,2.2,2.4,2.0,29,15,14,0.9,0.9,0.8,16,8,8,2,1,1,WWLDWLWWWWWWWDWWDDDWDWWWWWWWDWDWWW,2025-07-27 14:09:22.464827
214,94,2020,Maritimo,34,17,17,10,5,5,5,3,2,19,9,10,27,10,17,0.8,0.6,1.0,47,21,26,1.4,1.2,1.5,10,7,3,13,8,5,LWWLLDLLLWWDLWLLLLLLDLWLLWLWWWLDDL,2025-07-27 14:09:22.464906
215,94,2020,Moreirense,34,17,17,10,4,6,13,10,3,11,3,8,37,24,13,1.1,1.4,0.8,43,23,20,1.3,1.4,1.2,9,3,6,11,2,9,WLDDWLLLDDWLDWDLWWDLDWDLDWLDDLDWLW,2025-07-27 14:09:22.464999
216,94,2020,Portimonense,34,17,17,9,6,3,8,5,3,17,6,11,34,20,14,1.0,1.2,0.8,41,17,24,1.2,1.0,1.4,11,9,2,14,5,9,DLLWLLLWLDLWLWDLLDWLDWLLWWWLDDLLLD,2025-07-27 14:09:22.465082
217,94,2020,SC Braga,34,17,17,19,11,8,7,3,4,8,3,5,53,27,26,1.6,1.6,1.5,33,15,18,1.0,0.9,1.1,11,5,6,8,3,5,LLWWWWWWLWWLWLWWWDWWWWDLWDDWLLDDWD,2025-07-27 14:09:22.465172
218,94,2020,Tondela,34,17,17,10,8,2,6,2,4,18,7,11,36,18,18,1.1,1.1,1.1,57,21,36,1.7,1.2,2.1,6,6,0,12,6,6,DLLDWLWLLDLWLWLWLLWLWLLDWLWWDLDLLL,2025-07-27 14:09:22.465234
221,94,2020,Belenenses,34,17,17,9,6,3,13,5,8,12,6,6,25,15,10,0.7,0.9,0.6,35,18,17,1.0,1.1,1.0,13,6,7,18,7,11,WLDDLDDDWLLDLLWLDDDWDLWDLDWDWLWWLL,2025-07-27 14:09:22.465295
222,94,2020,Boavista,34,17,17,8,5,3,12,4,8,14,8,6,39,17,22,1.1,1.0,1.3,49,22,27,1.4,1.3,1.6,9,6,3,11,7,4,DLDLDWLDDDLDDLLWLLDWLWLLWDWLLDDLWW,2025-07-27 14:09:22.465386
224,94,2020,Guimaraes,34,17,17,12,7,5,7,1,6,15,9,6,37,21,16,1.1,1.2,0.9,44,27,17,1.3,1.6,1.0,12,5,7,11,3,8,LDWWLWLWWWLDWWWDDLDLWLLLLLWLLWDLDL,2025-07-27 14:09:22.465466
225,94,2020,Nacional,34,17,17,6,4,2,7,3,4,21,10,11,30,19,11,0.9,1.1,0.6,59,30,29,1.7,1.8,1.7,7,3,4,11,4,7,DWDLDDWLLLWLLLDWDWLLLLLLLLLLWLDLLL,2025-07-27 14:09:22.465551
226,94,2020,Rio Ave,36,18,18,7,4,3,13,6,7,16,8,8,25,12,13,0.7,0.7,0.7,45,20,25,1.3,1.1,1.4,11,8,3,21,11,10,DDDLWWDLDLLLWDLLDWWLLWDDLDDLDDLLLWLL,2025-07-27 14:09:22.465631
227,94,2020,Santa Clara,34,17,17,13,7,6,7,5,2,14,5,9,44,26,18,1.3,1.5,1.1,36,16,20,1.1,0.9,1.2,10,8,2,10,5,5,WWDLLWLLWLLDDLWWDWLLWLWDLWLDLDLWWW,2025-07-27 14:09:22.465709
228,94,2020,Sporting CP,34,17,17,26,13,13,7,4,3,1,0,1,65,34,31,1.9,2.0,1.8,20,10,10,0.6,0.6,0.6,20,9,11,1,0,1,WWDWWWWWDWWWWDWWWWWWDWWWDDWDWWWWLW,2025-07-27 14:09:22.465790
231,94,2020,Farense,34,17,17,7,4,3,10,6,4,17,7,10,31,19,12,0.9,1.1,0.7,48,20,28,1.4,1.2,1.6,6,2,4,16,6,10,LLLDLDWLWLDLWLLDLWDDDLLWLLLWDDDLWL,2025-07-27 14:09:22.465870
234,94,2020,Pacos Ferreira,34,17,17,15,10,5,8,3,5,11,4,7,40,23,17,1.2,1.4,1.0,41,19,22,1.2,1.1,1.3,9,6,3,11,5,6,DLLWDWWWLDDWWWWWWDLWLWLWLLLLDWDDLW,2025-07-27 14:09:22.465947
240,94,2020,Arouca,2,1,1,2,1,1,0,0,0,0,0,0,5,3,2,2.5,3.0,2.0,0,0,0,0.0,0.0,0.0,2,1,1,0,0,0,WW,2025-07-27 14:09:22.466029
242,94,2020,Famalicao,34,17,17,10,4,6,10,7,3,14,6,8,40,19,21,1.2,1.1,1.2,48,24,24,1.4,1.4,1.4,9,5,4,13,6,7,LWDDDLWLDDLLLWLLLLDWDLDWWDLWDLWWWL,2025-07-27 14:09:22.466108
762,94,2020,GIL Vicente,34,17,17,11,4,7,6,4,2,17,9,8,33,13,20,1.0,0.8,1.2,42,20,22,1.2,1.2,1.3,11,6,5,10,6,4,WDDLLLLWDLWDLLLLWLLWLLWWWLWLLDWDWL,2025-07-27 14:09:22.466190
810,94,2021,Vizela,34,17,17,7,4,3,12,7,5,15,6,9,37,16,21,1.1,0.9,1.2,58,21,37,1.7,1.2,2.2,2,1,1,11,6,5,LWLDDDDDLDDLWLLWLLWWDLLDLDDWLLWLDL,2025-07-27 14:09:22.466266
211,94,2021,Benfica,34,17,17,23,10,13,5,3,2,6,4,2,78,36,42,2.3,2.1,2.5,30,16,14,0.9,0.9,0.8,12,4,8,3,3,0,WWWWWWWLWDWWLWWLWDWLWWDWWDWLWWDWLW,2025-07-27 14:09:22.466344
212,94,2021,FC Porto,34,17,17,29,15,14,4,2,2,1,0,1,86,50,36,2.5,2.9,2.1,22,11,11,0.6,0.6,0.6,16,8,8,1,0,1,WWDWDWWWWWWWWWWWWWWWWDWDWWWWWWLWWW,2025-07-27 14:09:22.466424
214,94,2021,Maritimo,34,17,17,9,4,5,11,6,5,14,7,7,39,19,20,1.1,1.1,1.2,44,17,27,1.3,1.0,1.6,9,5,4,10,7,3,LWDLDDLDLLLWDWLWWWDLDWLDWLDLLWDLDL,2025-07-27 14:09:22.466503
215,94,2021,Moreirense,36,18,18,8,6,2,8,3,5,20,9,11,34,23,11,0.9,1.3,0.6,53,23,30,1.5,1.3,1.7,5,3,2,15,6,9,LDLDDLWDLDLDLLWLWDLLWLLDLLLLWWLLLWLW,2025-07-27 14:09:22.466581
216,94,2021,Portimonense,34,17,17,10,4,6,8,4,4,16,9,7,31,15,16,0.9,0.9,0.9,45,22,23,1.3,1.3,1.4,10,4,6,11,5,6,WLWLDWDWLLWWLWDLLDLLDDDDLLLLWLWLLW,2025-07-27 14:09:22.466659
217,94,2021,SC Braga,34,17,17,19,10,9,8,4,4,7,3,4,52,27,25,1.5,1.6,1.5,31,13,18,0.9,0.8,1.1,16,8,8,7,4,3,WLWDDWDDWWLWWLWWDLWWLWWDDLWWWDWWWL,2025-07-27 14:09:22.466743
218,94,2021,Tondela,34,17,17,7,4,3,7,4,3,20,9,11,41,24,17,1.2,1.4,1.0,67,33,34,2.0,1.9,2.0,2,1,1,10,4,6,WLLLLLWWLLWLLLLWDDLWLLLLDLDWLLDDLD,2025-07-27 14:09:22.466823
221,94,2021,Belenenses,34,17,17,5,5,0,11,3,8,18,9,9,23,15,8,0.7,0.9,0.5,55,30,25,1.6,1.8,1.5,8,4,4,17,6,11,LLLDDDDLDWLLLLLWLLDLLWLLDDDWLWDLLD,2025-07-27 14:09:22.466902
222,94,2021,Boavista,34,17,17,7,4,3,17,10,7,10,3,7,39,20,19,1.1,1.2,1.1,52,20,32,1.5,1.2,1.9,6,5,1,7,3,4,LWWDDLDDDLLLDLWDDDDLDDDWDDLWWLLWDD,2025-07-27 14:09:22.466993
223,94,2021,Chaves,2,1,1,1,1,0,0,0,0,1,0,1,2,2,0,1.0,2.0,0.0,1,0,1,0.5,0.0,1.0,1,1,0,1,0,1,WL,2025-07-27 14:09:22.467077
224,94,2021,Guimaraes,34,17,17,13,9,4,9,3,6,12,5,7,50,34,16,1.5,2.0,0.9,41,20,21,1.2,1.2,1.2,8,4,4,9,3,6,LDWDDDLWWLWLWWLDLDWLWLLLWWLWLWDDDW,2025-07-27 14:09:22.467165
227,94,2021,Santa Clara,34,17,17,9,8,1,13,6,7,12,3,9,38,24,14,1.1,1.4,0.8,54,23,31,1.6,1.4,1.8,8,5,3,10,4,6,LDLWLLDDLLLDWLWLWDWWDLDDWDDLWDDDWL,2025-07-27 14:09:22.467246
228,94,2021,Sporting CP,34,17,17,27,14,13,4,1,3,3,2,1,73,34,39,2.1,2.0,2.3,23,8,15,0.7,0.5,0.9,18,12,6,1,1,0,WWWDDWWWWWWWWWWWLWLWWDWDWWWWWLWWWW,2025-07-27 14:09:22.467329
230,94,2021,Estoril,34,17,17,9,4,5,12,8,4,13,5,8,36,21,15,1.1,1.2,0.9,43,21,22,1.3,1.2,1.3,11,6,5,11,4,7,WDWWWLDDWDDDLWDLLLLDDWLLDWLLLDDLWL,2025-07-27 14:09:22.467410
234,94,2021,Pacos Ferreira,34,17,17,9,5,4,11,6,5,14,6,8,29,19,10,0.9,1.1,0.6,44,22,22,1.3,1.3,1.3,10,4,6,13,5,8,WLLWDDDLDDLLLLWWLDDDDLWWLWWLWLDDLL,2025-07-27 14:09:22.467490
240,94,2021,Arouca,34,17,17,7,5,2,10,4,6,17,8,9,30,15,15,0.9,0.9,0.9,54,29,25,1.6,1.7,1.5,5,3,2,14,7,7,LLWLDDLLDWDWLLDLLLWDLLWDLLDWLDLWLD,2025-07-27 14:09:22.467571
242,94,2021,Famalicao,34,17,17,9,5,4,12,7,5,13,5,8,45,22,23,1.3,1.3,1.4,51,21,30,1.5,1.2,1.8,9,6,3,10,5,5,LLLDDDLLWDWLLLDDWDLDLWWWLDDLLDDWWW,2025-07-27 14:09:22.467654
762,94,2021,GIL Vicente,34,17,17,13,6,7,12,6,6,9,5,4,47,25,22,1.4,1.5,1.3,42,19,23,1.2,1.1,1.4,11,6,5,6,4,2,WWLLDDLDLWDDWWLWWDWWDWWDDWDLLDDLWL,2025-07-27 14:09:22.467738
15130,94,2022,Estrela,2,1,1,1,1,0,0,0,0,1,0,1,3,2,1,1.5,2.0,1.0,3,1,2,1.5,1.0,2.0,0,0,0,0,0,0,WL,2025-07-27 14:09:22.467817
810,94,2022,Vizela,34,17,17,11,5,6,7,4,3,16,8,8,34,18,16,1.0,1.1,0.9,38,19,19,1.1,1.1,1.1,11,5,6,13,8,5,WLDDLLLWWLDLWWLWLWLDDLWLWWWDLLLDLL,2025-07-27 14:09:22.467896
211,94,2022,Benfica,34,17,17,28,15,13,3,1,2,3,1,2,82,48,34,2.4,2.8,2.0,20,12,8,0.6,0.7,0.5,21,9,12,3,0,3,WWWWWWWDWWWWWLWDWWWWWWWWWWLLWWWWDW,2025-07-27 14:09:22.467993
212,94,2022,FC Porto,34,17,17,27,15,12,4,0,4,3,2,1,73,44,29,2.1,2.6,1.7,22,11,11,0.6,0.6,0.6,17,8,9,3,1,2,WWWLWWDWWLDWWWDWWWWWWLWWDWWWWWWWWW,2025-07-27 14:09:22.468071
214,94,2022,Maritimo,36,18,18,8,7,1,5,3,2,23,8,15,35,23,12,1.0,1.3,0.7,66,24,42,1.8,1.3,2.3,5,4,1,11,4,7,LLLLLLLLDDWDLDWLWLLLLWLLLWLWLLDLWLLW,2025-07-27 14:09:22.468148
216,94,2022,Portimonense,34,17,17,10,6,4,4,3,1,20,8,12,25,14,11,0.7,0.8,0.6,48,21,27,1.4,1.2,1.6,8,5,3,16,6,10,LWWWWLWLLLDWLLLDLLWLWLLLLLDWWLDLLL,2025-07-27 14:09:22.468224
217,94,2022,SC Braga,34,17,17,25,13,12,3,2,1,6,2,4,75,40,35,2.2,2.4,2.1,30,11,19,0.9,0.6,1.1,17,10,7,5,3,2,DWWWWWWLLWWLWWWWWLWWWLWWDWWWWWLWDW,2025-07-27 14:09:22.468302
222,94,2022,Boavista,34,17,17,12,8,4,8,6,2,14,3,11,43,23,20,1.3,1.4,1.2,54,21,33,1.6,1.2,1.9,6,5,1,9,3,6,WWLLWWWLDLDLLWLDWDLDLWDLLLWDWLWLDW,2025-07-27 14:09:22.468385
223,94,2022,Chaves,34,17,17,12,6,6,10,5,5,12,6,6,35,20,15,1.0,1.2,0.9,40,21,19,1.2,1.2,1.1,10,5,5,10,3,7,LWDWDLLDWWLDWLDDDLWDLLLWWLDWDWWWLL,2025-07-27 14:09:22.468462
224,94,2022,Guimaraes,34,17,17,16,10,6,5,3,2,13,4,9,34,18,16,1.0,1.1,0.9,39,12,27,1.1,0.7,1.6,14,9,5,12,7,5,WWLLLWDDWWWLWLDLLWWWDWWLLDLLLWWWWL,2025-07-27 14:09:22.468541
226,94,2022,Rio Ave,34,17,17,10,8,2,10,3,7,14,6,8,36,18,18,1.1,1.1,1.1,43,14,29,1.3,0.8,1.7,10,6,4,11,5,6,LLDWDLDWLWLWWDDLDLLWLWLWWLDDLWDLLD,2025-07-27 14:09:22.468618
227,94,2022,Santa Clara,34,17,17,5,4,1,7,5,2,22,8,14,26,18,8,0.8,1.1,0.5,58,29,29,1.7,1.7,1.7,5,2,3,16,5,11,DLLLWLDLLWDDWLLDLLDLLLLLLLLLDLWLWL,2025-07-27 14:09:22.468697
228,94,2022,Sporting CP,34,17,17,23,13,10,5,2,3,6,2,4,71,42,29,2.1,2.5,1.7,32,12,20,0.9,0.7,1.2,14,8,6,5,1,4,DWLLWWLWWWLWWWLDWWWLWWWWWDWDWWWWDW,2025-07-27 14:09:22.468776
230,94,2022,Estoril,34,17,17,10,7,3,5,2,3,19,8,11,33,20,13,1.0,1.2,0.8,49,24,25,1.4,1.4,1.5,8,5,3,14,6,8,WLDWLWDDWLDLLLWLLLWLLLLLLWLLLWLWDW,2025-07-27 14:09:22.468858
234,94,2022,Pacos Ferreira,34,17,17,6,3,3,5,2,3,23,12,11,26,13,13,0.8,0.8,0.8,62,33,29,1.8,1.9,1.7,3,1,2,16,8,8,LLLLLLDDLLLLLLDWLLWLWLLWDDLLLWLLWL,2025-07-27 14:09:22.468943
4716,94,2022,Casa Pia,34,17,17,11,6,5,8,5,3,15,6,9,31,18,13,0.9,1.1,0.8,40,17,23,1.2,1.0,1.4,11,7,4,14,6,8,DLWWDWWWLLWWLWDLLWLDDLWLWLLDLLDLDL,2025-07-27 14:09:22.469021
240,94,2022,Arouca,34,17,17,15,10,5,9,2,7,10,5,5,36,22,14,1.1,1.3,0.8,37,17,20,1.1,1.0,1.2,15,9,6,10,4,6,LWWLDLDDWDWWLLWDWLDWLWDWDWWDWLLLWW,2025-07-27 14:09:22.469102
242,94,2022,Famalicao,34,17,17,13,9,4,5,1,4,16,7,9,39,21,18,1.1,1.2,1.1,47,19,28,1.4,1.1,1.6,10,6,4,12,5,7,LLDWLLLWLWLDLWWLDWLLWWLWWLWWWLLDLD,2025-07-27 14:09:22.469179
762,94,2022,GIL Vicente,34,17,17,10,6,4,7,6,1,17,5,12,32,15,17,0.9,0.9,1.0,41,14,27,1.2,0.8,1.6,8,7,1,13,7,6,WLDDLWDLLLLLLWLWWLDWDWWLLDDLLLLWLW,2025-07-27 14:09:22.469256
15130,94,2023,Estrela,34,17,17,7,6,1,12,3,9,15,8,7,33,22,11,1.0,1.3,0.6,53,27,26,1.6,1.6,1.5,7,3,4,13,4,9,LLWDLDLWWLLDWDLDDLLLWLDLWDLDDDLDLW,2025-07-27 14:09:22.469336
810,94,2023,Vizela,34,17,17,5,3,2,11,5,6,18,9,9,36,20,16,1.1,1.2,0.9,66,32,34,1.9,1.9,2.0,8,4,4,11,6,5,LDLWLDLDLWDLLDDDLLLLWLDDWLLLLLDLWD,2025-07-27 14:09:22.469417
211,94,2023,Benfica,34,17,17,25,15,10,5,2,3,4,0,4,77,48,29,2.3,2.8,1.7,28,7,21,0.8,0.4,1.2,16,10,6,3,0,3,LWWWWWWWDWWDDWWWWWWWDWWLWWWLWWWLWD,2025-07-27 14:09:22.469494
212,94,2023,FC Porto,34,17,17,22,11,11,6,4,2,6,2,4,63,35,28,1.9,2.1,1.6,27,13,14,0.8,0.8,0.8,13,7,6,5,2,3,WWWDWWLWWLWWWLWDWWWDLWDWWWLLDWDWWW,2025-07-27 14:09:22.469570
215,94,2023,Moreirense,34,17,17,16,8,8,7,4,3,11,5,6,36,20,16,1.1,1.2,0.9,35,18,17,1.0,1.1,1.0,16,8,8,12,4,8,LDWLLWWDWWWDDWDLWLWLWLWDLWLDLLWWWW,2025-07-27 14:09:22.469647
216,94,2023,Portimonense,36,18,18,8,3,5,8,6,2,20,9,11,41,19,22,1.1,1.1,1.2,76,33,43,2.1,1.8,2.4,3,3,0,12,4,8,LLDDWLWLWLWLDLLLWLWLLDLDLLLWDDLLDWLL,2025-07-27 14:09:22.469727
217,94,2023,SC Braga,34,17,17,21,10,11,5,3,2,8,4,4,71,33,38,2.1,1.9,2.2,50,20,30,1.5,1.2,1.8,6,2,4,6,3,3,LWDWLWWWDWWWWLWDLWDWLWWWDWWLWWLWWL,2025-07-27 14:09:22.469803
21595,94,2023,AVS,2,1,1,2,1,1,0,0,0,0,0,0,4,2,2,2.0,2.0,2.0,2,1,1,1.0,1.0,1.0,0,0,0,0,0,0,WW,2025-07-27 14:09:22.469883
222,94,2023,Boavista,34,17,17,7,4,3,11,8,3,16,5,11,39,21,18,1.1,1.2,1.1,62,30,32,1.8,1.8,1.9,3,2,1,10,4,6,WWDWWLDDLLLLLDLDWLLDWLLDWLDLLDLDLD,2025-07-27 14:09:22.469985
223,94,2023,Chaves,34,17,17,5,3,2,8,4,4,21,10,11,31,21,10,0.9,1.2,0.6,72,37,35,2.1,2.2,2.1,4,1,3,14,5,9,LLLLLDWWLLLWLLLDLDDDLWDLDLLLWDLLLL,2025-07-27 14:09:22.470060
224,94,2023,Guimaraes,34,17,17,19,11,8,6,2,4,9,4,5,52,31,21,1.5,1.8,1.2,38,18,20,1.1,1.1,1.2,10,7,3,6,1,5,WWWLLDWWWLLWWDWDWWLWDDLWWWWWDLWLLW,2025-07-27 14:09:22.470134
226,94,2023,Rio Ave,34,17,17,6,6,0,19,8,11,9,3,6,38,25,13,1.1,1.5,0.8,43,20,23,1.3,1.2,1.4,10,6,4,9,2,7,WLLDDLLLLWDDDDLWLDDDWLDDDDDWDDDWDD,2025-07-27 14:09:22.470210
228,94,2023,Sporting CP,34,17,17,29,17,12,3,0,3,2,0,2,96,57,39,2.8,3.4,2.3,29,11,18,0.9,0.6,1.1,16,9,7,0,0,0,WWWDWWWWWWLWLWWWWWWWWDWWWWWWWWDWWW,2025-07-27 14:09:22.470288
230,94,2023,Estoril,34,17,17,9,8,1,6,1,5,19,8,11,49,25,24,1.4,1.5,1.4,58,18,40,1.7,1.1,2.4,10,8,2,5,3,2,LWLLLDLLLWWLWDWLLLDWLLDLLWWDLDWLLL,2025-07-27 14:09:22.470366
231,94,2023,Farense,34,17,17,10,6,4,7,4,3,17,7,10,46,24,22,1.4,1.4,1.3,51,23,28,1.5,1.4,1.6,7,6,1,9,4,5,LLWLWLLDWWWLDDLWLWLDDLLLLDLWDLWWLL,2025-07-27 14:09:22.470450
4716,94,2023,Casa Pia,34,17,17,10,3,7,8,5,3,16,9,7,38,10,28,1.1,0.6,1.6,50,18,32,1.5,1.1,1.9,10,6,4,13,9,4,WLDDWDLLDLLWLWLWLLLDLWWDLLWDDLWLLW,2025-07-27 14:09:22.470530
240,94,2023,Arouca,34,17,17,13,7,6,7,3,4,14,7,7,54,26,28,1.6,1.5,1.6,50,26,24,1.5,1.5,1.4,5,3,2,12,7,5,WDDDLLLLLLLWDWWLLWWWWLWWLLWWWDDDLL,2025-07-27 14:09:22.470613
242,94,2023,Famalicao,34,17,17,10,6,4,12,6,6,12,5,7,37,21,16,1.1,1.2,0.9,41,21,20,1.2,1.2,1.2,8,5,3,11,4,7,WDLWDWDLLWDLDDLDWLLDWLDLDWWDLDLWWL,2025-07-27 14:09:22.470685
762,94,2023,GIL Vicente,34,17,17,9,6,3,9,7,2,16,4,12,42,28,14,1.2,1.6,0.8,52,22,30,1.5,1.3,1.8,9,6,3,10,3,7,WLLLWLWLDLDLDLWLDWWLLWDDDLLLLWDDWL,2025-07-27 14:09:22.470752
15130,94,2024,Estrela,34,17,17,7,5,2,8,4,4,19,8,11,24,18,6,0.7,1.1,0.4,50,24,26,1.5,1.4,1.5,7,4,3,18,7,11,DLLLDLWLDLWLWLWDLLDLLWDDDLLWLLWLLL,2025-07-27 14:09:22.470811
810,94,2024,Vizela,2,1,1,0,0,0,1,1,0,1,0,1,2,2,0,1.0,2.0,0.0,5,2,3,2.5,2.0,3.0,0,0,0,1,0,1,LD,2025-07-27 14:09:22.470868
211,94,2024,Benfica,34,17,17,25,14,11,5,2,3,4,1,3,84,52,32,2.5,3.1,1.9,28,12,16,0.8,0.7,0.9,15,9,6,2,0,2,LWWDWWWWWWWWDWWLLWLWWWWWWWWWDWWWDD,2025-07-27 14:09:22.470919
212,94,2024,FC Porto,34,17,17,22,13,9,5,3,2,7,1,6,65,39,26,1.9,2.3,1.5,30,11,19,0.9,0.6,1.1,16,9,7,4,0,4,WWWLWWWWWWLWDWWWLLDDDWDWLWWLWWLWWW,2025-07-27 14:09:22.470971
215,94,2024,Moreirense,34,17,17,10,6,4,10,8,2,14,3,11,42,22,20,1.2,1.3,1.2,50,21,29,1.5,1.2,1.7,7,4,3,8,4,4,WWLDLDLWWLWLWLLDDDLLLWLDDWDWLLDLDW,2025-07-27 14:09:22.471025
217,94,2024,SC Braga,34,17,17,19,9,10,9,5,4,6,3,3,55,33,22,1.6,1.9,1.3,30,19,11,0.9,1.1,0.6,15,6,9,3,1,2,DWWDLWWLWWLWDDWLWWWWWDWLWWWDWWDDLD,2025-07-27 14:09:22.471076
21595,94,2024,AVS,36,18,18,6,4,2,13,6,7,17,8,9,30,16,14,0.8,0.9,0.8,62,26,36,1.7,1.4,2.0,9,5,4,12,6,6,DLWLWLDDLLDLDDDDDLWLLDDWLLLLLDLLWLWD,2025-07-27 14:09:22.471135
222,94,2024,Boavista,34,17,17,6,1,5,6,3,3,22,13,9,24,8,16,0.7,0.5,0.9,59,31,28,1.7,1.8,1.6,7,3,4,17,10,7,WLLDDLLDLWLDDLDLLLLLLLLWLLLWLWLWLL,2025-07-27 14:09:22.471193
224,94,2024,Guimaraes,34,17,17,14,9,5,12,5,7,8,3,5,47,29,18,1.4,1.7,1.1,37,19,18,1.1,1.1,1.1,13,9,4,9,3,6,WWLWWLDDDWLWLDDDDDLWDDDWWWDWWLWWLL,2025-07-27 14:09:22.471248
225,94,2024,Nacional,34,17,17,9,7,2,7,3,4,18,7,11,32,23,9,0.9,1.4,0.5,50,27,23,1.5,1.6,1.4,8,5,3,15,5,10,DLLWLLDLWLDLWLDLWWLLWDLWLWLLWLDLDL,2025-07-27 14:09:22.471324
226,94,2024,Rio Ave,34,17,17,9,6,3,11,8,3,14,3,11,39,25,14,1.1,1.5,0.8,55,24,31,1.6,1.4,1.8,5,3,2,10,2,8,LWLWLDLDLDWWLDLWDLWDDDLWLLLLWDLWDD,2025-07-27 14:09:22.471414
227,94,2024,Santa Clara,34,17,17,17,10,7,6,2,4,11,5,6,36,18,18,1.1,1.1,1.1,32,14,18,0.9,0.8,1.1,11,7,4,11,5,6,WLWWLWWLWLWWWLLWDLDWWLDLDWWLLDWDWW,2025-07-27 14:09:22.471507
228,94,2024,Sporting CP,34,17,17,25,14,11,7,2,5,2,1,1,88,40,48,2.6,2.4,2.8,27,13,14,0.8,0.8,0.8,15,6,9,2,1,1,WWWWWWWWWWWLLWDWDWWWDDDWWWWDWWWWDW,2025-07-27 14:09:22.471603
230,94,2024,Estoril,34,17,17,12,7,5,10,4,6,12,6,6,48,23,25,1.4,1.4,1.5,53,23,30,1.6,1.4,1.8,7,5,2,11,5,6,LLDDWDLLWLDWDLLDWWWWWDWLDDLWLLWLDW,2025-07-27 14:09:22.471690
231,94,2024,Farense,34,17,17,6,3,3,9,2,7,19,12,7,25,10,15,0.7,0.6,0.9,46,24,22,1.4,1.4,1.3,7,3,4,16,9,7,LLLLLLDWLLDWDLWDDDLLLLDLDLLDWLLWWL,2025-07-27 14:09:22.471775
4716,94,2024,Casa Pia,34,17,17,12,8,4,9,4,5,13,5,8,39,22,17,1.1,1.3,1.0,44,19,25,1.3,1.1,1.5,7,3,4,9,3,6,LLLWWDDLWDDLDWWWDWWLWLWLLLWDLDLDWL,2025-07-27 14:09:22.471860
240,94,2024,Arouca,34,17,17,9,5,4,11,6,5,14,6,8,35,16,19,1.0,0.9,1.1,49,19,30,1.4,1.1,1.8,8,5,3,9,5,4,LLWLLWLDLLDLLWLDWDWWDDDLWDLLDWLDDW,2025-07-27 14:09:22.471960
242,94,2024,Famalicao,34,17,17,12,7,5,11,7,4,11,3,8,44,20,24,1.3,1.2,1.4,39,12,27,1.1,0.7,1.6,13,9,4,7,5,2,WWWLDDDDLWDLDDLLDLDWDWWLWLWWWLDLLW,2025-07-27 14:09:22.472047
762,94,2024,GIL Vicente,34,17,17,8,5,3,10,5,5,16,7,9,34,18,16,1.0,1.1,0.9,47,19,28,1.4,1.1,1.6,7,4,3,13,7,6,LWDDDDLWLLLLWWDDDWLLLLLDLLWLLWWLDD,2025-07-27 14:09:22.472131
1607,253,2020,Chicago Fire,23,12,11,5,5,0,8,3,5,10,4,6,33,23,10,1.4,1.9,0.9,39,18,21,1.7,1.5,1.9,4,3,1,5,2,3,LDWLLLWLDLDLWWDLWDDLDDL,2025-07-27 14:09:22.472218
1595,253,2020,Seattle Sounders,27,16,11,14,11,3,6,3,3,7,2,5,52,38,14,1.9,2.4,1.3,33,17,16,1.2,1.1,1.5,7,4,3,4,1,3,WDDLWLWWDLWWLWWWLDDWLDWWWWL,2025-07-27 14:09:22.472299
1596,253,2020,San Jose Earthquakes,26,13,13,9,5,4,7,5,2,10,3,7,44,23,21,1.7,1.8,1.6,60,24,36,2.3,1.8,2.8,7,4,3,5,2,3,DLDWWWLLLDLDDLLWWWLWDLWWLD,2025-07-27 14:09:22.472397
1597,253,2020,FC Dallas,24,12,12,9,7,2,8,4,4,7,1,6,29,21,8,1.2,1.8,0.7,26,9,17,1.1,0.8,1.4,8,5,3,10,3,7,WDLDDWDLWWWLDDLWLDWWWLDL,2025-07-27 14:09:22.472461
1598,253,2020,Orlando City SC,29,16,13,13,9,4,10,5,5,6,2,4,48,31,17,1.7,1.9,1.3,33,18,15,1.1,1.1,1.2,5,2,3,3,1,2,DLWWDWDWLLWWDDWWWDWDDDLWWWLDL,2025-07-27 14:09:22.472520
1599,253,2020,Philadelphia Union,27,15,12,16,12,4,5,1,4,6,2,4,49,32,17,1.8,2.1,1.4,25,11,14,0.9,0.7,1.2,10,6,4,5,1,4,LDWWDWWLDWWLWWWDWLWWDWWWLWL,2025-07-27 14:09:22.472579
1600,253,2020,Houston Dynamo,23,10,13,4,3,1,9,4,5,10,3,7,30,14,16,1.3,1.4,1.2,40,12,28,1.7,1.2,2.2,3,3,0,5,1,4,DLDLDDWWWDLDLDLWLLDDLLL,2025-07-27 14:09:22.472666
1601,253,2020,Toronto FC,25,14,11,13,7,6,5,3,2,7,4,3,34,17,17,1.4,1.2,1.5,30,12,18,1.2,0.9,1.6,9,5,4,5,4,1,DWDWDLWWWLLWDWWWWWDWLLWLL,2025-07-27 14:09:22.472753
1602,253,2020,New York Red Bulls,24,10,14,9,5,4,5,1,4,10,4,6,31,13,18,1.3,1.3,1.3,34,12,22,1.4,1.2,1.6,5,2,3,6,3,3,WDWLLWLDLLWLWWLLWDDDWLWL,2025-07-27 14:09:22.472818
1603,253,2020,Vancouver Whitecaps,24,11,13,9,6,3,1,0,1,14,5,9,27,21,6,1.1,1.9,0.5,44,20,24,1.8,1.8,1.8,4,1,3,11,2,9,LWLLWDLLLWLWWLLLLWWLWLLW,2025-07-27 14:09:22.472881
1604,253,2020,New York City FC,26,12,14,13,7,6,4,0,4,9,5,4,42,25,17,1.6,2.1,1.2,30,16,14,1.2,1.3,1.0,7,2,5,7,2,5,LLLLWWLLWWWDWDLWWWLDLWWWWD,2025-07-27 14:09:22.472972
1605,253,2020,Los Angeles Galaxy,22,12,10,6,4,2,4,2,2,12,6,6,27,16,11,1.2,1.3,1.1,46,23,23,2.1,1.9,2.3,4,2,2,7,3,4,DLLLDWWWWDLLLLLLWLLWDL,2025-07-27 14:09:22.473058
1606,253,2020,Real Salt Lake,23,13,10,5,4,1,7,4,3,11,5,6,27,14,13,1.2,1.1,1.3,40,18,22,1.7,1.4,2.2,7,5,2,9,5,4,DDWDLLWDDLWLLWDLLLWDLLL,2025-07-27 14:09:22.473127
2242,253,2020,FC Cincinnati,24,11,13,4,2,2,5,4,1,15,5,10,13,5,8,0.5,0.5,0.6,37,10,27,1.5,0.9,2.1,7,5,2,14,8,6,LLLWWDDLDDLLWDLLLLWLLLLL,2025-07-27 14:09:22.473191
1608,253,2020,Atlanta United FC,23,13,10,6,4,2,4,2,2,13,7,6,23,10,13,1.0,0.8,1.3,30,12,18,1.3,0.9,1.8,6,5,1,8,6,2,WWLLLWLDDLLLWLWDLDLLLWL,2025-07-27 14:09:22.473243
1609,253,2020,New England Revolution,28,11,17,11,3,8,8,5,3,9,3,6,33,12,21,1.2,1.1,1.2,29,12,17,1.0,1.1,1.0,7,3,4,10,5,5,LDWDDLDWDLWLDWWDLWWLDLWLWWWL,2025-07-27 14:09:22.473324
1610,253,2020,Colorado Rapids,19,7,12,8,3,5,4,3,1,7,1,6,32,15,17,1.7,2.1,1.4,31,10,21,1.6,1.4,1.8,4,1,3,3,0,3,WWLLDLDDDWLWWLLWWWL,2025-07-27 14:09:22.473410
1611,253,2020,Sporting Kansas City,25,14,11,12,6,6,5,3,2,8,5,3,42,25,17,1.7,1.8,1.5,34,22,12,1.4,1.6,1.1,8,5,3,3,2,1,WWLWWDLWLDDLWLLWWWLDWWWDL,2025-07-27 14:09:22.473470
1612,253,2020,Minnesota United FC,27,10,17,12,6,6,8,3,5,7,1,6,50,22,28,1.9,2.2,1.6,34,9,25,1.3,0.9,1.5,9,5,4,5,1,4,WWWDDDWLLLLWWLDLDWDDWWDWWWL,2025-07-27 14:09:22.473522
1613,253,2020,Columbus Crew,28,16,12,16,14,2,6,1,5,6,1,5,46,32,14,1.6,2.0,1.2,24,9,15,0.9,0.6,1.3,12,9,3,3,0,3,WDWWWDWLDWWDWWLDLLWDLWLWWWWW,2025-07-27 14:09:22.473583
1614,253,2020,CF Montreal,25,13,12,8,4,4,2,1,1,15,8,7,34,16,18,1.4,1.2,1.5,46,21,25,1.8,1.6,2.1,3,2,1,5,4,1,WDLLWLWLWLWLLLLDWLLWLLLWL,2025-07-27 14:09:22.473668
1615,253,2020,DC United,23,12,11,5,2,3,6,4,2,12,6,6,25,12,13,1.1,1.0,1.2,41,21,20,1.8,1.8,1.8,4,2,2,7,4,3,LWDDLDLLWDLDLLLLLDWWWLL,2025-07-27 14:09:22.473800
1616,253,2020,Los Angeles FC,25,14,11,10,8,2,6,4,2,9,2,7,53,39,14,2.1,2.8,1.3,44,20,24,1.8,1.4,2.2,3,3,0,4,1,3,WDDWDWDLLWLLWLWLWWLDWWLDL,2025-07-27 14:09:22.473896
1617,253,2020,Portland Timbers,28,15,13,14,7,7,8,4,4,6,4,2,55,25,30,2.0,1.7,2.3,40,21,19,1.4,1.4,1.5,5,4,1,2,2,0,LWWWDDWWWLDLWLDWWWWWLDDWWLDD,2025-07-27 14:09:22.473985
9568,253,2020,Inter Miami,24,10,14,7,5,2,3,2,1,14,3,11,25,14,11,1.0,1.4,0.8,38,14,24,1.6,1.4,1.7,3,2,1,7,2,5,LLLLLWLDDWLWLLLWWDLWLLWL,2025-07-27 14:09:22.474066
9569,253,2020,Nashville SC,26,12,14,10,5,5,8,5,3,8,2,6,28,17,11,1.1,1.4,0.8,24,9,15,0.9,0.8,1.1,11,5,6,9,2,7,LLWDLLWDDWLWDDDLWWDWDLWWWL,2025-07-27 14:09:22.474158
1606,253,2021,Real Salt Lake,37,17,20,15,9,6,7,4,3,15,4,11,57,30,27,1.5,1.8,1.4,57,21,36,1.5,1.2,1.8,8,4,4,7,2,5,WWLDDDWLDLWLDWDLLWWLLWLWWLWLWLWLLWDWL,2025-07-27 14:09:22.474237
1595,253,2021,Seattle Sounders,35,18,17,17,8,9,10,6,4,8,4,4,53,28,25,1.5,1.6,1.5,33,15,18,0.9,0.8,1.1,11,8,3,7,4,3,WDWWWWDDWWDDWLWLLDWWWLWLWWWWLDLLDDD,2025-07-27 14:09:22.474316
1596,253,2021,San Jose Earthquakes,34,17,17,10,5,5,11,5,6,13,7,6,46,25,21,1.4,1.5,1.2,54,24,30,1.6,1.4,1.8,5,3,2,9,4,5,LWWWLLLLDLLDDDDWDWDDWLDLWWLLLWDLWD,2025-07-27 14:09:22.474402
1597,253,2021,FC Dallas,34,17,17,7,5,2,12,7,5,15,5,10,47,25,22,1.4,1.5,1.3,56,21,35,1.6,1.2,2.1,4,4,0,10,4,6,DLWDLDLDLWDLLLWWDWLLDWLDDLLLDLDLWD,2025-07-27 14:09:22.474482
1598,253,2021,Orlando City SC,35,17,18,13,8,5,12,7,5,10,2,8,51,29,22,1.5,1.7,1.2,51,18,33,1.5,1.1,1.8,9,6,3,4,2,2,DDWDWWLWWWLLDWLWDDDWDWLLLLDWWDDLDWL,2025-07-27 14:09:22.474566
1599,253,2021,Philadelphia Union,37,20,17,15,12,3,13,4,9,9,4,5,51,28,23,1.4,1.4,1.4,38,13,25,1.0,0.7,1.5,13,10,3,4,2,2,DLLWDWWWDWDLDWLDDWLWDLLWWDWWDLWDWDWDL,2025-07-27 14:09:22.474649
1600,253,2021,Houston Dynamo,34,17,17,6,6,0,12,6,6,16,5,11,36,21,15,1.1,1.2,0.9,54,22,32,1.6,1.3,1.9,5,4,1,10,5,5,WLDDWLWLDDDDLDDDLLLLDLLWDWLDLWLLLL,2025-07-27 14:09:22.474759
1601,253,2021,Toronto FC,34,17,17,6,4,2,10,7,3,18,6,12,39,24,15,1.1,1.4,0.9,66,27,39,1.9,1.6,2.3,2,1,1,10,3,7,LDLWDLLLLLLWDDWDLDLLLLLLWDWWLLDDDL,2025-07-27 14:09:22.474872
1602,253,2021,New York Red Bulls,35,17,18,13,8,5,9,6,3,13,3,10,39,19,20,1.1,1.1,1.1,34,11,23,1.0,0.6,1.3,13,9,4,8,3,5,LLWWLLWWLDWDDLLDLLWLDLWDWDWWWWLWDDL,2025-07-27 14:09:22.474985
2242,253,2021,FC Cincinnati,34,17,17,4,1,3,8,5,3,22,11,11,37,17,20,1.1,1.0,1.2,74,29,45,2.2,1.7,2.6,6,3,3,13,7,6,DLLLWLLWWDDLDLDDDDLLLWLLLLLLLLLLLL,2025-07-27 14:09:22.475099
1604,253,2021,New York City FC,38,18,20,16,11,5,11,4,7,11,3,8,63,39,24,1.7,2.2,1.2,40,13,27,1.1,0.7,1.4,12,10,2,6,2,4,LWWDDLWLWWLLWWWDDWLWLLDWDLLDLDWWWDWDWD,2025-07-27 14:09:22.475218
1605,253,2021,Los Angeles Galaxy,34,17,17,13,8,5,9,5,4,12,4,8,50,29,21,1.5,1.7,1.2,54,22,32,1.6,1.3,1.9,5,3,2,7,1,6,WWLWWLWLWWLWLDLWWDWLLDDDLLLDWWDLDD,2025-07-27 14:09:22.475330
1603,253,2021,Vancouver Whitecaps,35,17,18,12,10,2,13,3,10,10,4,6,46,25,21,1.3,1.5,1.2,48,17,31,1.4,1.0,1.7,7,5,2,8,4,4,WDLWLLLLLDDLWDDDDDWWWWLDWDWLWWDWDDL,2025-07-27 14:09:22.475454
1607,253,2021,Chicago Fire,34,17,17,9,7,2,7,5,2,18,5,13,36,23,13,1.1,1.4,0.8,54,18,36,1.6,1.1,2.1,8,7,1,14,5,9,DLLLLWLLLDWWLDLDDWWLLWLLLLDWLDWWLL,2025-07-27 14:09:22.475544
1608,253,2021,Atlanta United FC,35,17,18,13,9,4,12,5,7,10,3,7,45,25,20,1.3,1.5,1.1,39,14,25,1.1,0.8,1.4,10,7,3,10,4,6,DWLDWDDDLDLDLDLLDWWWWLWWWLWLWDWDDWL,2025-07-27 14:09:22.475627
1609,253,2021,New England Revolution,35,18,17,22,12,10,8,4,4,5,2,3,67,33,34,1.9,1.8,2.0,43,20,23,1.2,1.1,1.4,8,4,4,4,2,2,DWWLDWWWWWLDLWWWWDWWWWLWWDWWWDWDWLD,2025-07-27 14:09:22.475710
1610,253,2021,Colorado Rapids,35,18,17,17,9,8,10,7,3,8,2,6,51,31,20,1.5,1.7,1.2,36,15,21,1.0,0.8,1.2,13,7,6,7,3,4,DLWWWLWWLDWDWLWDWWWDWDDDDWLWLDWLWWL,2025-07-27 14:09:22.475793
1611,253,2021,Sporting Kansas City,36,19,17,18,10,8,7,5,2,11,4,7,62,36,26,1.7,1.9,1.5,43,20,23,1.2,1.1,1.4,8,4,4,5,1,4,WDLWLWWWDLWWWDWLWDWDDDLWWLWWLWWLLLWL,2025-07-27 14:09:22.475875
1612,253,2021,Minnesota United FC,35,17,18,13,10,3,10,3,7,12,4,8,43,24,19,1.2,1.4,1.1,47,14,33,1.3,0.8,1.8,11,8,3,8,3,5,LLLLWWDDWWDLWWDDWLDDWLLWWLDLWWDLWDL,2025-07-27 14:09:22.475955
1613,253,2021,Columbus Crew,34,17,17,13,10,3,8,3,5,13,4,9,46,33,13,1.4,1.9,0.8,45,22,23,1.3,1.3,1.4,8,5,3,11,2,9,DDWLLWWWLDDDWDWLLLLLLWLLWDWLWDLWWW,2025-07-27 14:09:22.476035
1614,253,2021,CF Montreal,34,17,17,12,9,3,10,4,6,12,4,8,46,29,17,1.4,1.7,1.0,44,23,21,1.3,1.4,1.2,8,5,3,9,4,5,WDDLWLLWDDWWWLLLDLWDDWLWWLLWDDDLWL,2025-07-27 14:09:22.476119
1615,253,2021,DC United,34,17,17,14,11,3,5,1,4,15,5,10,56,32,24,1.6,1.9,1.4,54,17,37,1.6,1.0,2.2,9,6,3,7,3,4,WLLLWLLWWDLWLDWDWWLLLWDWLWWLDLLWLW,2025-07-27 14:09:22.476198
1616,253,2021,Los Angeles FC,34,17,17,12,8,4,9,6,3,13,3,10,53,34,19,1.6,2.0,1.1,51,23,28,1.5,1.4,1.6,6,4,2,3,0,3,WDDLLWLDWLWWWLDDLLLLDWWWLLLDWWDWDL,2025-07-27 14:09:22.476281
1617,253,2021,Portland Timbers,38,20,18,20,13,7,5,3,2,13,4,9,63,41,22,1.7,2.1,1.2,54,24,30,1.4,1.2,1.7,11,6,5,4,1,3,LWLLWWLWDLLWWLLDWLDLWWWDWWWWLLLWWWWWWD,2025-07-27 14:09:22.476363
9568,253,2021,Inter Miami,34,17,17,12,7,5,5,2,3,17,8,9,36,26,10,1.1,1.5,0.6,53,35,18,1.6,2.1,1.1,7,2,5,14,4,10,LWDDLWLLLLLLDWDWLWWDWWWLLLLLLWWLLW,2025-07-27 14:09:22.476440
9569,253,2021,Nashville SC,36,18,18,13,9,4,19,9,10,4,0,4,59,38,21,1.6,2.1,1.2,35,19,16,1.0,1.1,0.9,13,5,8,9,1,8,DDDWDWDLWDWDWDWDDLWDWWWLWDDDDDLWDDWD,2025-07-27 14:09:22.476521
16489,253,2021,Austin,34,17,17,9,7,2,4,2,2,21,8,13,35,27,8,1.0,1.6,0.5,56,25,31,1.6,1.5,1.8,5,3,2,17,6,11,LWWLLLDDDLDWLLLWLLLWLLLLLWLWLLWLWL,2025-07-27 14:09:22.476601
18310,253,2022,Charlotte,34,17,17,13,10,3,3,1,2,18,6,12,44,28,16,1.3,1.6,0.9,52,16,36,1.5,0.9,2.1,8,7,1,11,4,7,LLLWWLWLDLWLWLWDLLWWLLWLLWLLLWWWDL,2025-07-27 14:09:22.476695
1606,253,2022,Real Salt Lake,35,17,18,12,9,3,12,5,7,11,3,8,45,27,18,1.3,1.6,1.0,47,15,32,1.3,0.9,1.8,10,8,2,10,3,7,DWWWLDDLDWLWWWLWDLDLWLDLWDDWLDLLDWD,2025-07-27 14:09:22.476775
1595,253,2022,Seattle Sounders,34,17,17,12,9,3,5,3,2,17,5,12,47,29,18,1.4,1.7,1.1,46,19,27,1.4,1.1,1.6,6,4,2,9,3,6,LLWDWLLLWWLWWDWLWLLLWLWLLDLLWWLDLD,2025-07-27 14:09:22.476837
1596,253,2022,San Jose Earthquakes,34,17,17,8,7,1,11,6,5,15,4,11,52,31,21,1.5,1.8,1.2,69,27,42,2.0,1.6,2.5,4,3,1,8,1,7,LDLLDLDWLWDWDLDLWDWLLDLDLWLWLLDLWD,2025-07-27 14:09:22.476892
1597,253,2022,FC Dallas,36,18,18,14,10,4,12,5,7,10,3,7,50,29,21,1.4,1.6,1.2,40,16,24,1.1,0.9,1.3,8,4,4,8,2,6,DLWWDWDWDWWLLWLDLDDLDWWLDWWLDWWDLWDL,2025-07-27 14:09:22.476972
1598,253,2022,Orlando City SC,35,17,18,14,9,5,6,0,6,15,8,7,44,26,18,1.3,1.5,1.0,55,28,27,1.6,1.6,1.5,9,4,5,7,4,3,WDLWDLWWLWLWDLDWLLWDDLLLWWWWLLWLLWL,2025-07-27 14:09:22.477057
1599,253,2022,Philadelphia Union,37,19,18,21,14,7,11,5,6,5,0,5,79,53,26,2.1,2.8,1.4,30,10,20,0.8,0.5,1.1,16,9,7,6,1,5,DWWWWWLDDDDDWDDWLDWWWWWLWLWWWWWDLWWWD,2025-07-27 14:09:22.477138
1600,253,2022,Houston Dynamo,34,17,17,10,6,4,6,5,1,18,6,12,43,24,19,1.3,1.4,1.1,56,22,34,1.6,1.3,2.0,6,5,1,8,4,4,DLWDWWDLLLWLWLLWLLDLWLLLLDLWLDWLWL,2025-07-27 14:09:22.477226
1601,253,2022,Toronto FC,34,17,17,9,7,2,7,3,4,18,7,11,49,30,19,1.4,1.8,1.1,66,29,37,1.9,1.7,2.2,3,1,2,11,3,8,DLLWWDWLLLLLDWLWLLDLLWDWWDLWDLLLLL,2025-07-27 14:09:22.477306
1602,253,2022,New York Red Bulls,35,18,17,15,6,9,8,5,3,12,7,5,51,27,24,1.5,1.5,1.4,43,24,19,1.2,1.3,1.1,8,3,5,10,5,5,WWLDWLDWWDDDLWLWLWWDLWLDLWDWWLWLLWL,2025-07-27 14:09:22.477387
1603,253,2022,Vancouver Whitecaps,34,17,17,12,10,2,7,3,4,15,4,11,40,25,15,1.2,1.5,0.9,57,20,37,1.7,1.2,2.2,9,7,2,8,3,5,LDLLWLLLWDWLWWLWDWLDDLDWLWDLLLWWWL,2025-07-27 14:09:22.477472
2242,253,2022,FC Cincinnati,36,17,19,13,6,7,13,6,7,10,5,5,66,37,29,1.8,2.2,1.5,58,27,31,1.6,1.6,1.6,6,4,2,6,1,5,LLWWLLDLWWWWLLDWDDDDLDDWDDDWDWWDLWWL,2025-07-27 14:09:22.477559
1605,253,2022,Los Angeles Galaxy,36,18,18,15,9,6,8,4,4,13,5,8,61,36,25,1.7,2.0,1.4,54,25,29,1.5,1.4,1.6,8,5,3,7,2,5,WWLLWWDWLWLDLWDLWLLLWLLWDWDDDLWWDWWL,2025-07-27 14:09:22.477640
1604,253,2022,New York City FC,37,18,19,18,11,7,7,4,3,12,3,9,64,40,24,1.7,2.2,1.3,45,19,26,1.2,1.1,1.4,15,8,7,7,2,5,LDWLLWWWDWWWWDLDDWWWWDLLLWLLLDLWWWWWL,2025-07-27 14:09:22.477720
1607,253,2022,Chicago Fire,34,17,17,10,6,4,9,5,4,15,6,9,39,18,21,1.1,1.1,1.2,48,17,31,1.4,1.0,1.8,12,8,4,13,6,7,DDWWDLDLLLLDLLWLWLLWWWDWLLLDDWLLWD,2025-07-27 14:09:22.477799
1608,253,2022,Atlanta United FC,34,17,17,10,8,2,10,5,5,14,4,10,48,31,17,1.4,1.8,1.0,54,24,30,1.6,1.4,1.8,6,3,3,7,3,4,WLWDWLDLLWDDLWLLDLWDLDWDLDWLLWWDLL,2025-07-27 14:09:22.477882
1609,253,2022,New England Revolution,34,17,17,10,7,3,12,6,6,12,4,8,47,22,25,1.4,1.3,1.5,50,16,34,1.5,0.9,2.0,9,6,3,7,4,3,DWLLLLWLWDDWDWDWDDLLDDWWDLLDWLLLWD,2025-07-27 14:09:22.477963
1610,253,2022,Colorado Rapids,34,17,17,11,10,1,10,5,5,13,2,11,46,29,17,1.4,1.7,1.0,57,15,42,1.7,0.9,2.5,9,8,1,6,1,5,LWWDDLLDWLWLWLDLLDDWLWWDLDLLDWWLWD,2025-07-27 14:09:22.478044
1611,253,2022,Sporting Kansas City,34,17,17,11,9,2,7,2,5,16,6,10,42,25,17,1.2,1.5,1.0,54,17,37,1.6,1.0,2.2,8,6,2,11,5,6,LWLLWLLLDDDLWDLLWLLWDLLLWLWWDDWWWL,2025-07-27 14:09:22.478130
1612,253,2022,Minnesota United FC,35,17,18,14,8,6,7,5,2,14,4,10,49,27,22,1.4,1.6,1.2,52,20,32,1.5,1.2,1.8,5,4,1,8,3,5,DDWWLLWWLLLDWLLLWWWDWWDLWWWLLLDLLWD,2025-07-27 14:09:22.478210
1613,253,2022,Columbus Crew,34,17,17,10,7,3,16,6,10,8,4,4,46,22,24,1.4,1.3,1.4,41,15,26,1.2,0.9,1.5,9,7,2,10,6,4,WDWDLLLDWDLLWDDWDWDWDLWDDDWDDLDWDL,2025-07-27 14:09:22.478274
1614,253,2022,CF Montreal,36,19,17,21,10,11,5,3,2,10,6,4,66,33,33,1.8,1.7,1.9,53,24,29,1.5,1.3,1.7,8,5,3,5,3,2,LLLDWWWDWWWLLWLWWLLWWDWDWWWLWDWWWWWL,2025-07-27 14:09:22.478331
1615,253,2022,DC United,34,17,17,7,4,3,6,4,2,21,9,12,36,22,14,1.1,1.3,0.8,71,34,37,2.1,2.0,2.2,6,4,2,16,6,10,WWLLLLWLWDLDLLLWLDLLWLDLLLLWDDLLLL,2025-07-27 14:09:22.478400
1616,253,2022,Los Angeles FC,37,20,17,23,15,8,5,3,2,9,2,7,75,48,27,2.0,2.4,1.6,43,20,23,1.2,1.0,1.4,10,7,3,3,1,2,WDWWWLWWWDLLWWDWWLWWWWWWWLLLWLDWWLWWD,2025-07-27 14:09:22.478479
1617,253,2022,Portland Timbers,34,17,17,11,8,3,13,6,7,10,3,7,53,28,25,1.6,1.6,1.5,53,19,34,1.6,1.1,2.0,6,4,2,4,2,2,DDWLDLWDDLDWLLLDWWDWDWDDDLLWWWWDLL,2025-07-27 14:09:22.478559
9568,253,2022,Inter Miami,35,17,18,14,10,4,6,3,3,15,4,11,47,34,13,1.3,2.0,0.7,59,28,31,1.7,1.6,1.7,6,2,4,10,2,8,DLLLLWWWLLDDWWLWDLLWLDWDWWLLLWWWWLL,2025-07-27 14:09:22.478641
9569,253,2022,Nashville SC,35,17,18,13,6,7,11,6,5,11,5,6,52,30,22,1.5,1.8,1.2,42,21,21,1.2,1.2,1.2,9,5,4,5,1,4,WDLLWWDLDWLWDWDLWDLWLDDDLLWWWWDDLWL,2025-07-27 14:09:22.478727
16489,253,2022,Austin,37,19,18,17,9,8,9,7,2,11,3,8,69,46,23,1.9,2.4,1.3,55,26,29,1.5,1.4,1.6,8,4,4,6,1,5,WWLDDWWWWLLWDLWDWWWWDLWDWLWLLLWDLDDWL,2025-07-27 14:09:22.478807
18310,253,2023,Charlotte,35,17,18,10,6,4,13,8,5,12,3,9,47,24,23,1.3,1.4,1.3,57,21,36,1.6,1.2,2.0,7,5,2,8,4,4,LLLWDDLDWLWWWLWLLDDDDDLWDDDDLLWWDWL,2025-07-27 14:09:22.478896
1607,253,2023,Chicago Fire,34,17,17,10,6,4,10,7,3,14,4,10,39,26,13,1.1,1.5,0.8,51,22,29,1.5,1.3,1.7,9,5,4,12,3,9,DLDWDWDLDLWLDDDLLWWLWWWLLLLDLDWWLL,2025-07-27 14:09:22.478982
20787,253,2023,St. Louis City,36,18,18,17,11,6,5,2,3,14,5,9,64,42,22,1.8,2.3,1.2,51,21,30,1.4,1.2,1.7,8,6,2,8,3,5,WWWWWLLWDLLWWWLDLLWWWLWWLWLDDDWWLLLL,2025-07-27 14:09:22.479044
1595,253,2023,Seattle Sounders,38,20,18,16,9,7,11,6,5,11,5,6,45,22,23,1.2,1.1,1.3,36,12,24,0.9,0.6,1.3,16,12,4,13,7,6,WWLDWWWLWDLWLLWLDDLDWWLDLDWDDWDWDWWLWL,2025-07-27 14:09:22.479107
1596,253,2023,San Jose Earthquakes,35,17,18,10,8,2,15,7,8,10,2,8,39,25,14,1.1,1.5,0.8,43,16,27,1.2,0.9,1.5,10,5,5,7,2,5,LWWLDWDWLDWLLDWDWDLLDDWWLLDDWLDDDDD,2025-07-27 14:09:22.479171
1597,253,2023,FC Dallas,37,18,19,12,8,4,13,7,6,12,3,9,44,26,18,1.2,1.4,0.9,41,17,24,1.1,0.9,1.3,7,3,4,8,2,6,LWDWLDWWLDWWDDLLWLLWLLDWLDDWDDDDDWLWL,2025-07-27 14:09:22.479233
1598,253,2023,Orlando City SC,37,19,18,20,10,10,9,5,4,8,4,4,57,32,25,1.5,1.7,1.4,41,21,20,1.1,1.1,1.1,13,7,6,7,3,4,WDDLWLWLWLDDWDWWLDDWWLWWWDWWLDWWWWWWL,2025-07-27 14:09:22.479293
1599,253,2023,Philadelphia Union,37,18,19,17,11,6,10,6,4,10,1,9,61,36,25,1.6,2.0,1.3,43,14,29,1.2,0.8,1.5,11,8,3,8,4,4,WLWLLDLDWWWDWWWWLDWLLWWWLWDDDDDWDLWWL,2025-07-27 14:09:22.479354
1600,253,2023,Houston Dynamo,39,20,19,16,13,3,11,5,6,12,2,10,56,40,16,1.4,2.0,0.8,43,13,30,1.1,0.7,1.6,14,10,4,12,4,8,LLWWLWDWDLLDWLLWWWLLDLDWWWDDWLDDWWWDDWL,2025-07-27 14:09:22.479414
1601,253,2023,Toronto FC,34,17,17,4,4,0,10,6,4,20,7,13,26,19,7,0.8,1.1,0.4,59,22,37,1.7,1.3,2.2,6,4,2,18,6,12,LDDWDDDDLWLLDLWDDDLLLLLLLLWLLLLLLL,2025-07-27 14:09:22.479466
2242,253,2023,FC Cincinnati,38,20,18,22,15,7,10,2,8,6,3,3,64,39,25,1.7,2.0,1.4,43,16,27,1.1,0.8,1.5,14,10,4,4,1,3,WDWDWWWLWDWWWWWWDWLDDWWLWWLDDWWLWDWDWL,2025-07-27 14:09:22.479517
1603,253,2023,Vancouver Whitecaps,36,18,18,12,8,4,12,6,6,12,4,8,57,35,22,1.6,1.9,1.2,54,20,34,1.5,1.1,1.9,8,5,3,6,3,3,LLDDDWWDDWLLWLWDDWLLWWLWWDWLLDDWDDLL,2025-07-27 14:09:22.479575
1602,253,2023,New York Red Bulls,37,19,18,12,8,4,11,6,5,14,5,9,42,27,15,1.1,1.4,0.8,45,20,25,1.2,1.1,1.4,9,5,4,13,5,8,LDDWDLDDLDLWDWLWLDWLWLLWLLLDDWLWWWWLD,2025-07-27 14:09:22.479636
1604,253,2023,New York City FC,34,17,17,9,8,1,14,6,8,11,3,8,35,23,12,1.0,1.4,0.7,39,16,23,1.1,0.9,1.4,9,7,2,10,3,7,LDWWLDDWWLLLDLLDDDDDWDDLLLWDDWWDLW,2025-07-27 14:09:22.479692
1606,253,2023,Real Salt Lake,37,18,19,14,6,8,10,5,5,13,7,6,51,26,25,1.4,1.4,1.3,54,28,26,1.5,1.6,1.4,9,5,4,9,6,3,WLLLLWLWDDLDWDLWDWWDWWDWLLWLLWWLDWLDD,2025-07-27 14:09:22.479754
1605,253,2023,Los Angeles Galaxy,34,17,17,8,6,2,12,6,6,14,5,9,51,31,20,1.5,1.8,1.2,67,29,38,2.0,1.7,2.2,6,3,3,9,2,7,LDDDLLLWLLWLLLWDDDDWWLWWDDLWDDLLDL,2025-07-27 14:09:22.479808
1608,253,2023,Atlanta United FC,37,18,19,14,11,3,12,4,8,11,3,8,72,46,26,1.9,2.6,1.4,61,23,38,1.6,1.3,2.0,8,4,4,3,0,3,WDWWLWDDWLLLWDDDDWDLWWLLWWLDWDWLDDLWL,2025-07-27 14:09:22.479867
1609,253,2023,New England Revolution,36,18,18,15,12,3,10,4,6,11,2,9,59,37,22,1.6,2.1,1.2,50,17,33,1.4,0.9,1.8,8,5,3,5,1,4,WWLWWDWDWDWLLDDDWWWDLWWLWDDLDWLLLWLL,2025-07-27 14:09:22.479945
1610,253,2023,Colorado Rapids,34,17,17,5,3,2,12,8,4,17,6,11,26,13,13,0.8,0.8,0.8,54,16,38,1.6,0.9,2.2,9,7,2,17,8,9,LDLLDDWDDDWLLLLLDLDLWDDLLLWLLDWLDL,2025-07-27 14:09:22.480006
1611,253,2023,Sporting Kansas City,38,19,19,14,10,4,9,3,6,15,6,9,54,32,22,1.4,1.7,1.2,54,22,32,1.4,1.2,1.7,8,5,3,12,6,6,LDDLLDLLLLWWDLWWDWLDLWDDLWWLWLWLWWDWWL,2025-07-27 14:09:22.480068
1612,253,2023,Minnesota United FC,34,17,17,10,4,6,11,9,2,13,4,9,46,24,22,1.4,1.4,1.3,51,20,31,1.5,1.2,1.8,8,3,5,5,2,3,WDWDWLLLDLLWWDLDLDWLWDWDWDDLLLDLWL,2025-07-27 14:09:22.480125
1613,253,2023,Columbus Crew,40,20,20,21,15,6,9,4,5,10,1,9,82,49,33,2.1,2.5,1.7,55,17,38,1.4,0.9,1.9,10,8,2,2,0,2,LWDLWWWDLLDWLLWWWDWWDDLWWLWLWDDWDWWLWWWW,2025-07-27 14:09:22.480211
1614,253,2023,CF Montreal,34,17,17,12,10,2,5,3,2,17,4,13,36,26,10,1.1,1.5,0.6,52,12,40,1.5,0.7,2.4,11,9,2,15,4,11,LLLWLLLWWWWLLWDLWWDLLLWWWLLDDLLDWL,2025-07-27 14:09:22.480304
1615,253,2023,DC United,34,17,17,10,6,4,10,6,4,14,5,9,45,31,14,1.3,1.8,0.8,49,23,26,1.4,1.4,1.5,11,6,5,10,2,8,WLDLLDLWWWLDDWLDWLLWLWDLLLWDDDLDLW,2025-07-27 14:09:22.480388
1616,253,2023,Los Angeles FC,39,19,20,18,12,6,10,3,7,11,4,7,64,43,21,1.6,2.3,1.1,43,19,24,1.1,1.0,1.2,14,7,7,10,3,7,WWDWDWWDLWDWDLLWWLLLDWDWLLLWDDLWWDWWWWL,2025-07-27 14:09:22.480478
1617,253,2023,Portland Timbers,34,17,17,11,9,2,10,3,7,13,5,8,46,29,17,1.4,1.7,1.0,58,22,36,1.7,1.3,2.1,8,4,4,8,2,6,WLLLDDLWLWDWDLLDWDLDLDWLLWDWWWWDLL,2025-07-27 14:09:22.480560
9568,253,2023,Inter Miami,34,17,17,9,6,3,7,5,2,18,6,12,41,25,16,1.2,1.5,0.9,54,21,33,1.6,1.2,1.9,5,4,1,11,4,7,WWLLLLLLWWWLLLLLLLDDDLWDWWLWDDLLDL,2025-07-27 14:09:22.480628
9569,253,2023,Nashville SC,36,18,18,13,9,4,10,4,6,13,5,8,39,25,14,1.1,1.4,0.8,34,14,20,0.9,0.8,1.1,11,6,5,16,7,9,WDWLLWDLDWWDWWWWDWLLWLLLLDDWDDLDWLLL,2025-07-27 14:09:22.480694
16489,253,2023,Austin,34,17,17,10,7,3,9,4,5,15,6,9,49,28,21,1.4,1.6,1.2,55,22,33,1.6,1.3,1.9,6,6,0,7,2,5,LWWLDLDLDDLWWLWLLWWDWLWLLLDLDDLWLD,2025-07-27 14:09:22.480755
1603,253,2024,Vancouver Whitecaps,38,19,19,15,8,7,8,4,4,15,7,8,61,34,27,1.6,1.8,1.4,52,26,26,1.4,1.4,1.4,9,6,3,8,4,4,DWWLWWLWDDLLDLWWLLWWDWWLWDWDLDLLLLWLWL,2025-07-27 14:09:22.480815
18310,253,2024,Charlotte,37,18,19,14,9,5,11,6,5,12,3,9,47,25,22,1.3,1.4,1.2,40,15,25,1.1,0.8,1.3,13,10,3,10,5,5,WDLLWDLWLLWWWDDLWWDWLLWDDDLLLWDWWWLDD,2025-07-27 14:09:22.480879
20787,253,2024,St. Louis City,34,17,17,8,7,1,13,5,8,13,5,8,50,23,27,1.5,1.4,1.6,63,21,42,1.9,1.2,2.5,7,6,1,8,4,4,DWDDDLDWDDWLLLDDLLDLWLLLDDWDLWWLWL,2025-07-27 14:09:22.480934
1595,253,2024,Seattle Sounders,38,18,20,17,8,9,11,8,3,10,2,8,54,25,29,1.4,1.4,1.5,38,14,24,1.0,0.8,1.2,14,9,5,10,5,5,LDDLLWDLLWDWLDWDLWDWWWWWLWLWWDWWWDDDWL,2025-07-27 14:09:22.480999
1596,253,2024,San Jose Earthquakes,34,17,17,6,4,2,3,1,2,25,12,13,41,18,23,1.2,1.1,1.4,78,32,46,2.3,1.9,2.7,2,1,1,10,6,4,LLLLWLLLLDWWLLDLLLLLLWLLLWLLDLLWLL,2025-07-27 14:09:22.481062
1597,253,2024,FC Dallas,34,17,17,11,10,1,8,2,6,15,5,10,54,34,20,1.6,2.0,1.2,56,25,31,1.6,1.5,1.8,7,4,3,6,2,4,WLLLLDDLWLWDDLLDWWLLWLWWDWLDLWLLDW,2025-07-27 14:09:22.481120
1598,253,2024,Orlando City SC,39,21,18,17,9,8,9,5,4,13,7,6,63,32,31,1.6,1.5,1.7,52,20,32,1.3,1.0,1.8,12,9,3,10,5,5,DLLLWDWDLLWDWLDLLDWLWWWWDLWWWLWWWLWDDWL,2025-07-27 14:09:22.481183
1599,253,2024,Philadelphia Union,34,17,17,9,4,5,10,5,5,15,8,7,62,27,35,1.8,1.6,2.1,55,23,32,1.6,1.4,1.9,8,5,3,5,4,1,DDDWWWDLLDLLWDDDLLLLLDLWWLWLWWDLLL,2025-07-27 14:09:22.481244
1600,253,2024,Houston Dynamo,36,18,18,15,7,8,11,8,3,10,3,7,48,23,25,1.3,1.3,1.4,40,16,24,1.1,0.9,1.3,9,4,5,9,4,5,DLWWWLWLLDWLDLWDDDWWLDWWLWDWDWLWLWDD,2025-07-27 14:09:22.481307
1601,253,2024,Toronto FC,34,17,17,11,7,4,4,0,4,19,10,9,40,27,13,1.2,1.6,0.8,61,32,29,1.8,1.9,1.7,8,3,5,9,2,7,DWWLWLLLWWWLLWLDDLLLLLLWLWWLWLLDLL,2025-07-27 14:09:22.481367
1602,253,2024,New York Red Bulls,39,18,21,14,7,7,15,8,7,10,3,7,62,33,29,1.6,1.8,1.4,54,25,29,1.4,1.4,1.4,10,5,5,7,3,4,DWWLWDWDDDLWWLWWLDDWDDDDWDLDLDLWLLWDWWL,2025-07-27 14:09:22.481446
2242,253,2024,FC Cincinnati,37,19,18,19,8,11,6,4,2,12,7,5,60,27,33,1.6,1.4,1.8,51,22,29,1.4,1.2,1.6,9,7,2,7,6,1,DWDWWDLLWWWWWWWLWWLWWWLLLLWDWDLLLWWLD,2025-07-27 14:09:22.481533
1604,253,2024,New York City FC,38,19,19,15,11,4,9,3,6,14,5,9,57,38,19,1.5,2.0,1.0,53,28,25,1.4,1.5,1.3,6,3,3,11,2,9,LLLWLDDWWWLWWWWWLLLWWLDDDDLDLDWWWLLWDL,2025-07-27 14:09:22.481600
1605,253,2024,Los Angeles Galaxy,39,21,18,24,17,7,7,3,4,8,1,7,87,57,30,2.2,2.7,1.7,54,28,26,1.4,1.3,1.4,9,5,4,4,0,4,DWDDWWLWWLDDDDWWLWWWWLWLWWWLWLWWWLWWWWW,2025-07-27 14:09:22.481664
1606,253,2024,Real Salt Lake,36,18,18,16,11,5,13,4,9,7,3,4,66,38,28,1.8,2.1,1.6,49,20,29,1.4,1.1,1.6,10,7,3,8,5,3,LDWLWWDDWWWDWWDDWDWLWWLDLLWLWDDDWWDD,2025-07-27 14:09:22.481721
1607,253,2024,Chicago Fire,34,17,17,7,5,2,9,4,5,18,8,10,40,20,20,1.2,1.2,1.2,62,31,31,1.8,1.8,1.8,4,2,2,11,6,5,DLLWDLWDLDLLLLDDWWLLWLDWLDLLWLLDLL,2025-07-27 14:09:22.481783
1608,253,2024,Atlanta United FC,39,18,21,12,7,5,11,4,7,16,7,9,54,32,22,1.4,1.8,1.0,57,28,29,1.5,1.6,1.4,5,2,3,9,2,7,LWWLWDDLDLLLDLWLDWDWLLLDWLWLDDDLWWDLWWL,2025-07-27 14:09:22.481839
1609,253,2024,New England Revolution,34,17,17,9,5,4,4,4,0,21,8,13,37,19,18,1.1,1.1,1.1,74,30,44,2.2,1.8,2.6,5,3,2,10,3,7,LLLLDWLLLWLLLWWWWLWLLLDWLDLDLWLLLL,2025-07-27 14:09:22.481899
1610,253,2024,Colorado Rapids,36,18,18,15,10,5,5,3,2,16,5,11,62,34,28,1.7,1.9,1.6,69,26,43,1.9,1.4,2.4,6,3,3,5,2,3,LDWDLWDWWLWLWLDLLWWWLWWDLWWWLWLLLLLL,2025-07-27 14:09:22.481956
1611,253,2024,Sporting Kansas City,34,17,17,8,6,2,7,4,3,19,7,12,51,33,18,1.5,1.9,1.1,66,32,34,1.9,1.9,2.0,3,2,1,6,2,4,DDDWLWDLDLLLLLLLWLLLWLWWLDWDLWLLLL,2025-07-27 14:09:22.482031
1612,253,2024,Minnesota United FC,37,18,19,15,7,8,9,5,4,13,6,7,61,31,30,1.6,1.7,1.6,56,24,32,1.5,1.3,1.7,8,3,5,6,1,5,WDWWLDLWWWDWDLWDLLLLLLDLWLWWLWWDWWDDL,2025-07-27 14:09:22.482101
1613,253,2024,Columbus Crew,36,18,18,19,10,9,10,4,6,7,4,3,74,38,36,2.1,2.1,2.0,43,22,21,1.2,1.2,1.2,12,7,5,6,3,3,WDWWLDDDDDLWWWWLWWWWWDLWWLDWWDLWWWLD,2025-07-27 14:09:22.482183
1614,253,2024,CF Montreal,35,18,17,11,8,3,11,6,5,13,4,9,50,30,20,1.4,1.7,1.2,66,25,41,1.9,1.4,2.4,8,6,2,10,4,6,DWWLLLWDDLLLLDWDDDLWLDWDLLLWDWWWLWD,2025-07-27 14:09:22.482264
1615,253,2024,DC United,34,17,17,10,4,6,10,5,5,14,8,6,52,26,26,1.5,1.5,1.5,70,36,34,2.1,2.1,2.0,2,1,1,8,2,6,WDDLDWDLLWDWLLDLDLLLDLLWWLWWDLDWWL,2025-07-27 14:09:22.482340
1616,253,2024,Los Angeles FC,38,20,18,21,13,8,7,4,3,10,3,7,67,40,27,1.8,2.0,1.5,49,21,28,1.3,1.1,1.6,13,8,5,6,2,4,WLDLWLWDDWLWWWWWWDWWWLDWLDLDLWWWWWWLWL,2025-07-27 14:09:22.482417
1617,253,2024,Portland Timbers,35,17,18,12,9,3,11,5,6,12,3,9,65,39,26,1.9,2.3,1.4,61,25,36,1.7,1.5,2.0,6,4,2,6,2,4,WDWLLLDDDLLLWLWWDDWWWLWWLDWLWDDLDDL,2025-07-27 14:09:22.482494
9568,253,2024,Inter Miami,37,19,18,23,12,11,8,4,4,6,3,3,84,49,35,2.3,2.6,1.9,55,26,29,1.5,1.4,1.6,6,4,2,2,0,2,WDWLWLDDWWWWWDWWLDWWWWLWWWWWDDDWWWWLL,2025-07-27 14:09:22.482574
9569,253,2024,Nashville SC,34,17,17,9,5,4,9,6,3,16,6,10,38,24,14,1.1,1.4,0.8,54,25,29,1.6,1.5,1.7,9,4,5,11,3,8,DDDWLDLLDWLWDDWLDWWLLLLLLLLWWDLLLW,2025-07-27 14:09:22.482660
16489,253,2024,Austin,34,17,17,11,7,4,9,5,4,14,5,9,39,27,12,1.1,1.6,0.7,48,25,23,1.4,1.5,1.4,8,2,6,10,4,6,LDDDLWWLWWDLWWDLLLDWLWLLDWLLDLDWLW,2025-07-27 14:09:22.482736
128,71,2020,Santos,38,19,19,14,9,5,12,7,5,12,3,9,52,35,17,1.4,1.8,0.9,51,23,28,1.3,1.2,1.5,7,3,4,9,2,7,DLWWLLDWWDDDWDWLWLWDWLWDLLDWWLLLDDWWDL,2025-07-27 14:09:22.482817
129,71,2020,Ceara,38,19,19,14,7,7,10,5,5,14,7,7,54,22,32,1.4,1.2,1.7,51,25,26,1.3,1.3,1.4,11,4,7,8,5,3,LDLLWWWLLWLDLDWDWDDLDDWWLWDLWLWWLLDLWW,2025-07-27 14:09:22.482898
130,71,2020,Gremio,38,19,19,14,10,4,17,6,11,7,3,4,53,34,19,1.4,1.8,1.0,40,23,17,1.1,1.2,0.9,11,4,7,7,1,6,WDDDDLDWDDLDWLWDWWWWDWWDDWWDDDLLDDWLWL,2025-07-27 14:09:22.482990
131,71,2020,Corinthians,38,19,19,13,8,5,12,7,5,13,4,9,45,29,16,1.2,1.5,0.8,45,23,22,1.2,1.2,1.2,14,7,7,12,5,7,LDWDLWDLLWLDDDLWLWWDLDWDWWWWLWLLWDLLDD,2025-07-27 14:09:22.483051
133,71,2020,Vasco DA Gama,38,19,19,10,7,3,11,5,6,17,7,10,37,21,16,1.0,1.1,0.8,56,21,35,1.5,1.1,1.8,11,7,4,15,6,9,WWWDLDWLWLDLLLLLDLWDDLLDWLDWLLWDDLLLDW,2025-07-27 14:09:22.483109
134,71,2020,Atletico Paranaense,38,19,19,15,9,6,8,5,3,15,5,10,38,20,18,1.0,1.1,0.9,36,13,23,0.9,0.7,1.2,14,7,7,13,6,7,WWLLLLDLDWWLDLLDLLWWWWLLLWWWDDLWWDDWLW,2025-07-27 14:09:22.483190
144,71,2020,Atletico Goianiense,38,19,19,12,6,6,14,9,5,12,4,8,40,24,16,1.1,1.3,0.8,45,21,24,1.2,1.1,1.3,9,4,5,12,5,7,WDLLLDDWWLDDDLWWDLLDDWDLWWLDDLWWWLDLDW,2025-07-27 14:09:22.483269
147,71,2020,Coritiba,38,19,19,7,4,3,10,6,4,21,9,12,31,13,18,0.8,0.7,0.9,54,19,35,1.4,1.0,1.8,9,7,2,15,8,7,LLLLWWDLDLWLDLDWLLWDLLLDLLLLDWDDDLLWLL,2025-07-27 14:09:22.483346
151,71,2020,Goias,38,19,19,9,6,3,10,5,5,19,8,11,41,19,22,1.1,1.0,1.2,63,28,35,1.7,1.5,1.8,10,8,2,11,6,5,LDLWLLDWDLLLLDDLDLLWDLLWDLWWLLLWLWDWDL,2025-07-27 14:09:22.483430
794,71,2020,RB Bragantino,38,19,19,13,10,3,14,5,9,11,4,7,50,34,16,1.3,1.8,0.8,40,19,21,1.1,1.0,1.1,11,6,5,9,3,6,DDLWLLDLDLWDDLLDWWLDWWDDWLLWDWWWLWDDDW,2025-07-27 14:09:22.483513
154,71,2020,Fortaleza EC,38,19,19,10,8,2,11,6,5,17,5,12,34,20,14,0.9,1.1,0.7,44,15,29,1.2,0.8,1.5,13,11,2,18,9,9,LLDWDWLLWDWDDWDWLLLLDWDDLLDLDLWLLWWLLL,2025-07-27 14:09:22.483596
1062,71,2020,Atletico-MG,38,19,19,20,14,6,8,4,4,10,1,9,64,41,23,1.7,2.2,1.2,45,13,32,1.2,0.7,1.7,13,9,4,7,2,5,WWWLLWWLWWWWLWDLDLWWLDWDWLWDWDLWWLDDWW,2025-07-27 14:09:22.483684
118,71,2020,Bahia,38,19,19,12,9,3,8,2,6,18,8,10,48,27,21,1.3,1.4,1.1,59,26,33,1.6,1.4,1.7,7,5,2,11,4,7,WWDLDLDLLLLWLWLDWLWWWLLLLLLLDWLWDLDDWW,2025-07-27 14:09:22.483747
119,71,2020,Internacional,38,19,19,20,12,8,10,5,5,8,2,6,61,34,27,1.6,1.8,1.4,35,17,18,0.9,0.9,0.9,15,8,7,7,1,6,WWLWWWDDWLLDDWWWWDLDLLDDWWWWWWWWWDLWLD,2025-07-27 14:09:22.483804
120,71,2020,Botafogo,38,19,19,5,3,2,12,5,7,21,11,10,32,16,16,0.8,0.8,0.8,62,30,32,1.6,1.6,1.7,5,4,1,14,8,6,DDWDLDDDLDDLDWWLDDLLLLLLLWLLLLLLDLLLWL,2025-07-27 14:09:22.483858
121,71,2020,Palmeiras,38,19,19,15,9,6,13,8,5,10,2,8,51,33,18,1.3,1.7,0.9,37,16,21,1.0,0.8,1.1,12,7,5,7,1,6,DDWWDDWWDDDWLLLLWWWWLWDWLWWDWLLDDWLDDL,2025-07-27 14:09:22.483914
123,71,2020,Sport Recife,38,19,19,12,8,4,6,2,4,20,9,11,31,19,12,0.8,1.0,0.6,50,23,27,1.3,1.2,1.4,10,7,3,19,7,12,WLDLLLWWLDWWWLLLLDWDLLLLWDLWLLLWLWWDLL,2025-07-27 14:09:22.483969
124,71,2020,Fluminense,38,19,19,18,11,7,10,5,5,10,3,7,55,31,24,1.4,1.6,1.3,42,14,28,1.1,0.7,1.5,11,8,3,7,3,4,LDWLWWDLLWLWDWWDDWWLLWDWDLLWLWDWWWDWDW,2025-07-27 14:09:22.484034
126,71,2020,Sao Paulo,38,19,19,18,10,8,12,7,5,8,2,6,59,29,30,1.6,1.5,1.6,41,16,25,1.1,0.8,1.3,10,7,3,5,2,3,WLDWWWLWDDDDWWDWWWDDWWWWLWWLLDLDLDWDLW,2025-07-27 14:09:22.484093
127,71,2020,Flamengo,38,19,19,21,11,10,8,4,4,9,4,5,68,35,33,1.8,1.8,1.7,48,23,25,1.3,1.2,1.3,9,3,6,6,2,4,LLWDDWWWWLDWWWWDWDLLDWWWWDLLWWLWWWDWWL,2025-07-27 14:09:22.484149
128,71,2021,Santos,38,19,19,12,9,3,14,6,8,12,4,8,35,21,14,0.9,1.1,0.7,40,14,26,1.1,0.7,1.4,17,11,6,16,8,8,LWDLWDWDLWLDLWDDDLLDDLDWLDLWWLWDWLWDWD,2025-07-27 14:09:22.484199
129,71,2021,Ceara,38,19,19,11,10,1,17,7,10,10,2,8,39,24,15,1.0,1.3,0.8,38,14,24,1.0,0.7,1.3,15,9,6,12,4,8,WLDLDWDDWDDWDWDLDLLDWDLDDLDDWWLWWDWLDL,2025-07-27 14:09:22.484255
130,71,2021,Gremio,38,19,19,12,8,4,7,6,1,19,5,14,44,29,15,1.2,1.5,0.8,51,21,30,1.3,1.1,1.6,10,7,3,13,5,8,LLLDDLLLDWDLWLWWLWWLLDLLWLLLLWLWWDLWDW,2025-07-27 14:09:22.484322
131,71,2021,Corinthians,38,19,19,15,10,5,12,5,7,11,4,7,40,26,14,1.1,1.4,0.7,36,18,18,0.9,0.9,0.9,12,6,6,10,2,8,LWDLDWDDDWLLWLDWWWDDDWDWLWLDWWLWLWLWDL,2025-07-27 14:09:22.484373
132,71,2021,Chapecoense-sc,38,19,19,1,0,1,12,6,6,25,13,12,27,13,14,0.7,0.7,0.7,67,32,35,1.8,1.7,1.8,3,1,2,18,9,9,LLDDDLDLLLLLLLLDDDLWLLDDLDLLLDDLLLLLLL,2025-07-27 14:09:22.484426
134,71,2021,Atletico Paranaense,38,19,19,13,8,5,8,5,3,17,6,11,41,23,18,1.1,1.2,0.9,45,21,24,1.2,1.1,1.3,9,4,5,15,7,8,WWWWLDWWLDLWLLLLLDLWWLWLDLLLDWWLLDLWDD,2025-07-27 14:09:22.484490
144,71,2021,Atletico Goianiense,38,19,19,13,6,7,14,10,4,11,3,8,33,17,16,0.9,0.9,0.8,36,14,22,0.9,0.7,1.2,16,8,8,14,7,7,WWDLWLLWDDLLWDDWDDDLDWLDLWWLLLDDDDWWWW,2025-07-27 14:09:22.484552
152,71,2021,Juventude,38,19,19,11,9,2,13,6,7,14,4,10,36,19,17,0.9,1.0,0.9,44,15,29,1.2,0.8,1.5,12,10,2,10,4,6,DLDLWDWWLLDLWLWDDDDLLWDLDLLDDWWWLDWLLW,2025-07-27 14:09:22.484615
154,71,2021,Fortaleza EC,38,19,19,17,11,6,7,4,3,14,4,10,44,26,18,1.2,1.4,0.9,45,19,26,1.2,1.0,1.4,14,9,5,12,5,7,WWWDDLDWLWWWWLWDDDLLLWLWLWWWLLDLLWLWLW,2025-07-27 14:09:22.484674
794,71,2021,RB Bragantino,38,19,19,14,7,7,14,9,5,10,3,7,55,28,27,1.4,1.5,1.4,46,20,26,1.2,1.1,1.4,11,7,4,8,2,6,WDDWWWWDWDDDLWDLWDLDLDDWWDDWWLLLWLDLLW,2025-07-27 14:09:22.484742
1062,71,2021,Atletico-MG,38,19,19,26,17,9,6,1,5,6,1,5,67,42,25,1.8,2.2,1.3,34,13,21,0.9,0.7,1.1,16,9,7,3,0,3,LWWWDLLWWWWWWWWWDDWWDWDWWLWLWWWWWDWWWL,2025-07-27 14:09:22.484834
1193,71,2021,Cuiaba,38,19,19,10,7,3,17,6,11,11,6,5,34,18,16,0.9,0.9,0.8,37,20,17,1.0,1.1,0.9,15,7,8,16,6,10,DLDDDLLDDWWLDDWLWDWWDDLDDWDLWDLLWDLLWD,2025-07-27 14:09:22.484920
118,71,2021,Bahia,38,19,19,11,8,3,10,5,5,17,6,11,42,27,15,1.1,1.4,0.8,51,22,29,1.3,1.2,1.5,13,8,5,16,6,10,WDLWDWLLWWLLLLDLLLWDDLLWDDWDDWLLDWLLWL,2025-07-27 14:09:22.485001
119,71,2021,Internacional,38,19,19,12,8,4,12,6,6,14,5,9,44,29,15,1.2,1.5,0.8,42,22,20,1.1,1.2,1.1,11,5,6,12,3,9,DLWLDWDLDLDWLDWWDDWWWLDWWLDDLWLWLLLDLL,2025-07-27 14:09:22.485087
121,71,2021,Palmeiras,38,19,19,20,11,9,6,3,3,12,5,7,58,33,25,1.5,1.7,1.3,43,26,17,1.1,1.4,0.9,13,5,8,8,2,6,LWDWWLWWWWWWWDLLLWLWLDLLDWWWWWWLLLDWDW,2025-07-27 14:09:22.485168
123,71,2021,Sport Recife,38,19,19,9,5,4,11,7,4,18,7,11,24,13,11,0.6,0.7,0.6,37,13,24,1.0,0.7,1.3,14,9,5,20,10,10,DLLWLLDDLDLWDWDLLDDLLLWWWLDLLWLLLWLDWD,2025-07-27 14:09:22.485237
124,71,2021,Fluminense,38,19,19,15,11,4,9,5,4,14,3,11,38,24,14,1.0,1.3,0.7,38,14,24,1.0,0.7,1.3,12,9,3,14,4,10,DWDWDLDLWDWLLLLDWDWWDWLDLWWLLWLWLWWLLW,2025-07-27 14:09:22.485298
125,71,2021,America Mineiro,38,19,19,13,9,4,14,6,8,11,4,7,41,22,19,1.1,1.2,1.0,37,11,26,1.0,0.6,1.4,13,9,4,14,7,7,LLLDLDDWWLLLDDWDLWWDDDWWDLDWWLWWDLDWDW,2025-07-27 14:09:22.485366
126,71,2021,Sao Paulo,38,19,19,11,7,4,15,9,6,12,3,9,31,18,13,0.8,0.9,0.7,39,15,24,1.0,0.8,1.3,14,9,5,16,7,9,DLLDLDDDLWWLLDWWWDLWDDDDDDWLWLDLWDWLWL,2025-07-27 14:09:22.485417
127,71,2021,Flamengo,38,19,19,21,13,8,8,1,7,9,5,4,69,31,38,1.8,1.6,2.0,36,15,21,0.9,0.8,1.1,14,9,5,7,5,2,WWLWLWLLWWWWLWDWWLDWDWWDLWDWDWWWWDWDLL,2025-07-27 14:09:22.485468
128,71,2022,Santos,38,19,19,12,8,4,11,5,6,15,6,9,44,28,16,1.2,1.5,0.8,41,19,22,1.1,1.0,1.2,11,6,5,14,4,10,DWWLWLDLDDDWDDLWLWDDWLWDLLLWLLWWLLWDLL,2025-07-27 14:09:22.485526
129,71,2022,Ceara,38,19,19,7,4,3,16,8,8,15,7,8,34,20,14,0.9,1.1,0.7,41,22,19,1.1,1.2,1.0,8,3,5,15,6,9,WLLLDDDWDWDDDDDLWWLLDLDDDWLLLDDDLLLLLW,2025-07-27 14:09:22.485582
131,71,2022,Corinthians,38,19,19,18,12,6,11,4,7,9,3,6,44,24,20,1.2,1.3,1.1,36,11,25,0.9,0.6,1.3,14,10,4,10,4,6,WWLWWDDDWLWDWDLWLWWWDLLWDDLWWDWWLDWWDL,2025-07-27 14:09:22.485633
134,71,2022,Atletico Paranaense,38,19,19,16,11,5,10,6,4,12,2,10,48,31,17,1.3,1.6,0.9,48,17,31,1.3,0.9,1.6,13,8,5,10,2,8,LLWLWLWWDWDDWWWLDWLWWLDDWDDLWDLWLLWLDW,2025-07-27 14:09:22.485699
144,71,2022,Atletico Goianiense,38,19,19,8,6,2,12,5,7,18,8,10,39,22,17,1.0,1.2,0.9,57,23,34,1.5,1.2,1.8,4,2,2,10,5,5,DLDDLLWDLWWLWDLLLLLLWDDLLLLLWWDDWLLDDD,2025-07-27 14:09:22.485765
145,71,2022,Avai,38,19,19,9,7,2,8,4,4,21,8,13,34,24,10,0.9,1.3,0.5,60,26,34,1.6,1.4,1.8,6,4,2,12,2,10,WLWDWLLLDLWWLDLLWLLLDDLLDDWLLLLLLLLDWW,2025-07-27 14:09:22.485836
147,71,2022,Coritiba,38,19,19,12,11,1,6,4,2,20,4,16,39,25,14,1.0,1.3,0.7,60,16,44,1.6,0.8,2.3,9,8,1,11,3,8,WLDWLWLWDDLLLLWDLLWLLLLWLWLWLWLLDLWWDL,2025-07-27 14:09:22.485928
151,71,2022,Goias,38,19,19,11,6,5,13,8,5,14,5,9,40,20,20,1.1,1.1,1.1,53,22,31,1.4,1.2,1.6,8,5,3,11,4,7,LDLDWWLDWDDLLWLWDLDWLDWWWDDLLDLWDDLWLL,2025-07-27 14:09:22.485994
152,71,2022,Juventude,38,19,19,3,2,1,13,9,4,22,8,14,29,18,11,0.8,0.9,0.6,69,27,42,1.8,1.4,2.2,4,3,1,15,5,10,DLLDDWLDWLLLLDLDDLWLLLDLDLDLLDLDLLLLDL,2025-07-27 14:09:22.486056
154,71,2022,Fortaleza EC,38,19,19,15,7,8,10,8,2,13,4,9,46,24,22,1.2,1.3,1.2,39,13,26,1.0,0.7,1.4,15,9,6,9,7,2,LLLDLLDLWDDLWLLDWLDWWWWWLLDWWDWWDWLDWW,2025-07-27 14:09:22.486122
794,71,2022,RB Bragantino,38,19,19,11,8,3,11,5,6,16,6,10,49,29,20,1.3,1.5,1.1,59,23,36,1.6,1.2,1.9,7,4,3,10,5,5,DWDWLDLDLWDWDLLWWWLWLLDLDDDDLWLLWLWLLL,2025-07-27 14:09:22.486180
1062,71,2022,Atletico-MG,38,19,19,15,8,7,13,5,8,10,6,4,45,25,20,1.2,1.3,1.1,37,18,19,1.0,0.9,1.0,16,8,8,11,5,6,WWDDLDWWDLDDWWWDWDLLLWLDWDLLWWDLDWDLWW,2025-07-27 14:09:22.486239
1193,71,2022,Cuiaba,38,19,19,10,6,4,11,8,3,17,5,12,31,17,14,0.8,0.9,0.7,42,15,27,1.1,0.8,1.4,9,6,3,13,5,8,WLWDLLDLLWDLDLWWLDLLLWDDDLDWLLLDLWWDLW,2025-07-27 14:09:22.486303
119,71,2022,Internacional,38,19,19,20,13,7,13,5,8,5,1,4,58,40,18,1.5,2.1,0.9,31,14,17,0.8,0.7,0.9,18,11,7,7,2,5,LWWDDDDDWDWWLWDWDDLWLWWWDWWDWDWWDWLWWW,2025-07-27 14:09:22.486360
120,71,2022,Botafogo,38,19,19,15,6,9,8,4,4,15,9,6,41,18,23,1.1,0.9,1.2,43,19,24,1.1,1.0,1.3,11,6,5,14,8,6,LWDDWWDLLLLWWLWLLLWLDDDLWDWWLWWLDWLWWL,2025-07-27 14:09:22.486426
121,71,2022,Palmeiras,38,19,19,23,13,10,12,4,8,3,2,1,66,39,27,1.7,2.1,1.4,27,12,15,0.7,0.6,0.8,19,11,8,6,3,3,LDDWDWWWDWWWWDLDWWWWWWDDDWWWWWDDWWWDWL,2025-07-27 14:09:22.486487
124,71,2022,Fluminense,38,19,19,21,12,9,7,3,4,10,4,6,63,39,24,1.7,2.1,1.3,41,20,21,1.1,1.1,1.1,14,6,8,9,4,5,DWLLDWWLLWLDWWWWDWWDWLWDLWWWLLLWDWWWWW,2025-07-27 14:09:22.486548
125,71,2022,America Mineiro,38,19,19,15,9,6,8,4,4,15,6,9,40,22,18,1.1,1.2,0.9,40,18,22,1.1,0.9,1.2,11,7,4,12,4,8,LWLWWLDDWLLDLLWLLLWWWWDDWDWLWLWLLDWWLD,2025-07-27 14:09:22.486605
126,71,2022,Sao Paulo,38,19,19,13,8,5,15,6,9,10,5,5,55,32,23,1.4,1.7,1.2,42,21,21,1.1,1.1,1.1,9,5,4,10,5,5,WLDWDWDDDDWLLDWDDDDLLWLLDDWWWLDWWWDLLW,2025-07-27 14:09:22.486670
127,71,2022,Flamengo,38,19,19,18,11,7,8,3,5,12,5,7,60,37,23,1.6,1.9,1.2,39,15,24,1.0,0.8,1.3,11,9,2,8,3,5,DWDLLDWWLLLWLWWLWWWWWWDWDDLLWDWWWWLLDL,2025-07-27 14:09:22.486735
128,71,2023,Santos,38,19,19,11,6,5,10,7,3,17,6,11,39,26,13,1.0,1.4,0.7,64,28,36,1.7,1.5,1.9,8,5,3,16,7,9,LDWLWWDLDDLLLWLDLDLWLLLWWWLLWDWDWDDLLL,2025-07-27 14:09:22.486797
130,71,2023,Gremio,38,19,19,21,14,7,5,2,3,12,3,9,63,34,29,1.7,1.8,1.5,56,16,40,1.5,0.8,2.1,8,8,0,9,3,6,WLWDLDWWWLWWWLWDLWLWWLDWDLLLWWWWWLLWWW,2025-07-27 14:09:22.486860
131,71,2023,Corinthians,38,19,19,12,6,6,14,10,4,12,3,9,47,26,21,1.2,1.4,1.1,48,23,25,1.3,1.2,1.3,10,4,6,8,2,6,WLLDLDLWLDWLLWDWDWDDDLDWLDDDWDWLDWLWLW,2025-07-27 14:09:22.486919
133,71,2023,Vasco DA Gama,38,19,19,12,9,3,9,2,7,17,8,9,41,24,17,1.1,1.3,0.9,51,23,28,1.3,1.2,1.5,9,6,3,12,6,6,WDLDDLLLLLLWLLLLWDWLDWWWLDWLLDWWWDDLLW,2025-07-27 14:09:22.486983
134,71,2023,Atletico Paranaense,38,19,19,14,10,4,14,8,6,10,1,9,51,33,18,1.3,1.7,0.9,43,19,24,1.1,1.0,1.3,10,7,3,8,1,7,WLLWWWLLWDLWDLWWDDWDDDWWLDWDWDLLDDDDWL,2025-07-27 14:09:22.487045
135,71,2023,Cruzeiro,38,19,19,11,4,7,14,8,6,13,7,6,35,14,21,0.9,0.7,1.1,32,17,15,0.8,0.9,0.8,16,6,10,17,9,8,LWWWLWLDLDLWDWDLDDLDLDWLDDLWWLLLWDWDDD,2025-07-27 14:09:22.487110
147,71,2023,Coritiba,38,19,19,8,4,4,6,4,2,24,11,13,41,17,24,1.1,0.9,1.3,73,28,45,1.9,1.5,2.4,6,4,2,11,8,3,LLDLDLLDLDLLWWDWLLLLLLLLWWLLLWLLWWLDLL,2025-07-27 14:09:22.487181
151,71,2023,Goias,38,19,19,9,5,4,11,7,4,18,7,11,36,19,17,0.9,1.0,0.9,53,25,28,1.4,1.3,1.5,10,6,4,14,8,6,LWLLLWDLLDWLLLDWDWWDDDLDDLWDLDLWLLLLLW,2025-07-27 14:09:22.487244
154,71,2023,Fortaleza EC,38,19,19,15,9,6,9,6,3,14,4,10,45,28,17,1.2,1.5,0.9,44,20,24,1.2,1.1,1.3,10,6,4,13,6,7,DWWDDDLWDLWWLWLLLLWWWLWWDWLLLLDLLDDWWW,2025-07-27 14:09:22.487308
794,71,2023,RB Bragantino,38,19,19,17,11,6,11,5,6,10,3,7,49,28,21,1.3,1.5,1.1,35,14,21,0.9,0.7,1.1,17,11,6,9,3,6,WDLDDDWWLDWWWDLDWWDLWDWWWDWWLWWLDLLLWL,2025-07-27 14:09:22.487373
1062,71,2023,Atletico-MG,38,19,19,19,11,8,9,3,6,10,5,5,52,28,24,1.4,1.5,1.3,32,16,16,0.8,0.8,0.8,15,7,8,7,2,5,LDWLWWWDWDDLDLDLLWWLWDWWWLWLWWWDDWWWWL,2025-07-27 14:09:22.487445
1193,71,2023,Cuiaba,38,19,19,14,6,8,9,6,3,15,7,8,40,23,17,1.1,1.2,0.9,39,22,17,1.0,1.2,0.9,13,5,8,15,7,8,LDLWLLWDWDLLWDWWWWLLLLDLWDWDLWLDWWDLLW,2025-07-27 14:09:22.487510
118,71,2023,Bahia,38,19,19,12,8,4,8,5,3,18,6,12,50,29,21,1.3,1.5,1.1,53,21,32,1.4,1.1,1.7,9,6,3,14,3,11,LLWWLLDLDDWLLDLDDWLWLDWLLWWWLLWLLDWLLW,2025-07-27 14:09:22.487566
119,71,2023,Internacional,38,19,19,15,9,6,10,5,5,13,5,8,46,30,16,1.2,1.6,0.8,45,21,24,1.2,1.1,1.3,11,6,5,14,6,8,DWWLLLLWDWWWDLDDLDLLDDWLLWLWWLDWDLWWWW,2025-07-27 14:09:22.487627
120,71,2023,Botafogo,38,19,19,18,11,7,10,4,6,10,4,6,58,36,22,1.5,1.9,1.2,37,17,20,1.0,0.9,1.1,15,9,6,8,2,6,WWWWWLWWLWWWWWWDWDWDWLLLDWWDLLLLDDDDDL,2025-07-27 14:09:22.487686
121,71,2023,Palmeiras,38,19,19,20,14,6,10,2,8,8,3,5,64,35,29,1.7,1.8,1.5,33,12,21,0.9,0.6,1.1,16,9,7,8,2,6,WDWWWDDDWWLLDDDWWLWWWDWLLLLWWWWWLWDWWD,2025-07-27 14:09:22.487749
124,71,2023,Fluminense,38,19,19,16,13,3,8,4,4,14,2,12,51,33,18,1.3,1.7,0.9,47,18,29,1.2,0.9,1.5,12,8,4,12,2,10,WWLDWWLLWDDWLWDLWWLWDWLWLLDLWLLDDWWWLL,2025-07-27 14:09:22.487814
125,71,2023,America Mineiro,38,19,19,5,5,0,9,2,7,24,12,12,42,21,21,1.1,1.1,1.1,81,38,43,2.1,2.0,2.3,2,2,0,11,7,4,LLLLDLWLWDLLDLDLLLLWWDLLDLLDLLDDLLLLWL,2025-07-27 14:09:22.487871
126,71,2023,Sao Paulo,38,19,19,14,13,1,11,3,8,13,3,10,40,29,11,1.1,1.5,0.6,38,13,25,1.0,0.7,1.3,15,10,5,13,5,8,LWDWDDWWLLWLWDWLDLDDLLLWWDLWLDWWDLDWLW,2025-07-27 14:09:22.487930
127,71,2023,Flamengo,38,19,19,19,10,9,9,5,4,10,4,6,56,26,30,1.5,1.4,1.6,42,16,26,1.1,0.8,1.4,15,10,5,8,3,5,WLLLWWWDWWLWWDDDWLDWDWLDWDWWLLWWDWWLWL,2025-07-27 14:09:22.487986
130,71,2024,Gremio,38,19,19,12,9,3,9,2,7,17,8,9,44,26,18,1.2,1.4,0.9,50,26,24,1.3,1.4,1.3,8,5,3,12,5,7,LWWLLLLLLDWDLLLWDWWWLWLDWLDWLLWDLDDWDL,2025-07-27 14:09:22.488051
131,71,2024,Corinthians,38,19,19,15,10,5,11,8,3,12,1,11,54,37,17,1.4,1.9,0.9,45,18,27,1.2,0.9,1.4,10,6,4,12,3,9,DLLWDLLDDLDDLWLLWWDLDDDLWLWLDWWWWWWWWW,2025-07-27 14:09:22.488111
133,71,2024,Vasco DA Gama,38,19,19,14,10,4,8,5,3,16,4,12,43,29,14,1.1,1.5,0.7,56,24,32,1.5,1.3,1.7,8,6,2,12,4,8,WLLLLWLLDLWLDWWWWLLDWDWWDLDDLWWLLLLDWW,2025-07-27 14:09:22.488171
134,71,2024,Atletico Paranaense,38,19,19,11,7,4,9,4,5,18,8,10,40,24,16,1.1,1.3,0.8,46,21,25,1.2,1.1,1.3,9,6,3,11,3,8,WLWDWWLWDDDLWLWLLWLDLLLDDLLLLWLLWWDDLL,2025-07-27 14:09:22.488236
135,71,2024,Cruzeiro,38,19,19,14,10,4,10,5,5,14,4,10,43,29,14,1.1,1.5,0.7,41,16,25,1.1,0.8,1.3,12,6,6,13,4,9,WDLWWLWDWLWLLWWWLWWLDDLDWLDDLDLLWLDDLW,2025-07-27 14:09:22.488297
136,71,2024,Vitoria,38,19,19,13,8,5,8,3,5,17,8,9,45,23,22,1.2,1.2,1.2,52,23,29,1.4,1.2,1.5,9,4,5,8,5,3,LDLLLLDDWWLWLLWLLLLWWLDLLWWLDWWWLWDWDD,2025-07-27 14:09:22.488348
140,71,2024,Criciuma,38,19,19,9,5,4,11,8,3,18,6,12,42,22,20,1.1,1.2,1.1,61,27,34,1.6,1.4,1.8,6,4,2,9,4,5,DDWLLLDWWLDWLDLLDWWLDLWLLDWLWDDLLLDLLL,2025-07-27 14:09:22.488397
144,71,2024,Atletico Goianiense,38,19,19,7,5,2,9,5,4,22,9,13,29,16,13,0.8,0.8,0.7,58,24,34,1.5,1.3,1.8,7,5,2,16,7,9,LLLDLWLDWLDDDLLLLLDLLLWWLLLWLDLWDLLDWL,2025-07-27 14:09:22.488459
152,71,2024,Juventude,38,19,19,11,8,3,12,6,6,15,5,10,48,27,21,1.3,1.4,1.1,59,24,35,1.6,1.3,1.8,6,5,1,7,3,4,DWLDDWDLWLWLLWDDLLDWLWLLDWLDDLLLWDDWWL,2025-07-27 14:09:22.488522
154,71,2024,Fortaleza EC,38,19,19,19,14,5,11,5,6,8,0,8,53,32,21,1.4,1.7,1.1,39,8,31,1.0,0.4,1.6,13,11,2,7,1,6,WDDDDWLLWDWWLWWWWDWWWWWLLDWWLDDWWDDLLW,2025-07-27 14:09:22.488587
794,71,2024,RB Bragantino,38,19,19,10,8,2,14,7,7,14,4,10,44,27,17,1.2,1.4,0.9,48,19,29,1.3,1.0,1.5,6,4,2,10,4,6,DWWDDLWLWLWLDWLLWLDDLLLWDLDDDLLDDDLDWW,2025-07-27 14:09:22.488649
1062,71,2024,Atletico-MG,38,19,19,11,7,4,14,7,7,13,5,8,47,27,20,1.2,1.4,1.1,54,26,28,1.4,1.4,1.5,9,5,4,11,3,8,DDWWDDWLLDWDLLWDWWLDDLWLWLDWDLLDLDDLLW,2025-07-27 14:09:22.488707
1193,71,2024,Cuiaba,38,19,19,6,3,3,12,5,7,20,11,9,29,16,13,0.8,0.8,0.7,49,23,26,1.3,1.2,1.4,10,6,4,20,9,11,LLLLLDWLWWDDDLDWLLLLDLWDLDLWDLLDDLDLLL,2025-07-27 14:09:22.488763
118,71,2024,Bahia,38,19,19,15,11,4,8,3,5,15,5,10,49,25,24,1.3,1.3,1.3,49,15,34,1.3,0.8,1.8,10,9,1,7,4,3,LWDWWWDWDLWWLWLWLLDDLWWDLWLWLDLLLLDWLW,2025-07-27 14:09:22.488820
119,71,2024,Internacional,38,19,19,18,11,7,11,5,6,9,3,6,53,30,23,1.4,1.6,1.2,36,15,21,0.9,0.8,1.1,12,7,5,7,2,5,WWLDWDLWWLDDLLDDDWLWDWWWWDWDWWDWWWWLLL,2025-07-27 14:09:22.488880
120,71,2024,Botafogo,38,19,19,23,12,11,10,5,5,5,2,3,59,31,28,1.6,1.6,1.5,29,13,16,0.8,0.7,0.8,18,9,9,5,3,2,LWWWLDWWWDLWDWWWWWDLWLWDWWWDWDWWDDDWWW,2025-07-27 14:09:22.488947
121,71,2024,Palmeiras,38,19,19,22,12,10,7,2,5,9,5,4,60,34,26,1.6,1.8,1.4,33,16,17,0.9,0.8,0.9,16,8,8,11,5,6,WLDDWLWWWWWLWDWWLWLLDDWWWWWWDWDLWWWLWL,2025-07-27 14:09:22.489027
124,71,2024,Fluminense,38,19,19,12,7,5,10,8,2,16,4,12,33,20,13,0.9,1.1,0.7,39,16,23,1.0,0.8,1.2,13,8,5,13,5,8,DLWLDLDLLLLLLDLDWWWWLDWWLLLWWWLDLDDDWW,2025-07-27 14:09:22.489120
126,71,2024,Sao Paulo,38,19,19,17,12,5,8,3,5,13,4,9,53,31,22,1.4,1.6,1.2,43,18,25,1.1,0.9,1.3,12,7,5,7,2,5,LLWDWWWDDLLWWWWLWDDLWWLWLWLWLWDWWDDLLL,2025-07-27 14:09:22.489204
127,71,2024,Flamengo,38,19,19,20,11,9,10,5,5,8,3,5,61,30,31,1.6,1.6,1.6,42,21,21,1.1,1.1,1.1,10,4,6,6,3,3,WWDLDWWWDWWLWWDLWWWLDLWLDLWWLWDWDWDWWD,2025-07-27 14:09:22.489263
4625,2,2020,Floriana,1,1,0,0,0,0,0,0,0,1,1,0,0,0,0,0.0,0.0,0.0,2,2,0,2.0,2.0,0.0,0,0,0,1,1,0,L,2025-07-27 14:09:22.489320
529,2,2020,Barcelona,8,4,4,5,2,3,1,0,1,2,2,0,18,8,10,2.3,2.0,2.5,10,9,1,1.3,2.3,0.3,3,0,3,1,1,0,WWWWWLLD,2025-07-27 14:09:22.489371
530,2,2020,Atletico Madrid,8,4,4,2,1,1,3,2,1,3,1,2,7,4,3,0.9,1.0,0.8,11,4,7,1.4,1.0,1.8,2,1,1,4,2,2,LWDDDWLL,2025-07-27 14:09:22.489449
536,2,2020,Sevilla,8,4,4,4,2,2,2,0,2,2,2,0,13,6,7,1.6,1.5,1.8,13,9,4,1.6,2.3,1.0,2,1,1,2,1,1,DWWWLWLD,2025-07-27 14:09:22.489531
541,2,2020,Real Madrid,12,6,6,6,4,2,3,1,2,3,1,2,19,14,5,1.6,2.3,0.8,14,8,6,1.2,1.3,1.0,4,1,3,3,0,3,LDWWLWWWWDDL,2025-07-27 14:09:22.489611
33,2,2020,Manchester United,6,3,3,3,2,1,0,0,0,3,1,2,15,10,5,2.5,3.3,1.7,10,4,6,1.7,1.3,2.0,1,1,0,0,0,0,WWLWLL,2025-07-27 14:09:22.489696
549,2,2020,Besiktas,1,0,1,0,0,0,0,0,0,1,0,1,1,0,1,1.0,0.0,1.0,3,0,3,3.0,0.0,3.0,0,0,0,0,0,0,L,2025-07-27 14:09:22.489775
550,2,2020,Shakhtar Donetsk,6,3,3,2,1,1,2,1,1,2,1,1,5,2,3,0.8,0.7,1.0,12,6,6,2.0,2.0,2.0,3,2,1,4,2,2,WDLLWD,2025-07-27 14:09:22.489844
40,2,2020,Liverpool,10,5,5,6,3,3,2,1,1,2,1,1,15,5,10,1.5,1.0,2.0,6,2,4,0.6,0.4,0.8,7,4,3,2,2,0,WWWLWDWWLD,2025-07-27 14:09:22.489906
553,2,2020,Olympiakos Piraeus,8,4,4,2,2,0,1,0,1,5,2,3,4,3,1,0.5,0.8,0.3,10,3,7,1.3,0.8,1.8,3,2,1,5,2,3,WDWLLLLL,2025-07-27 14:09:22.490001
556,2,2020,Qarabag,3,3,0,2,2,0,1,1,0,0,0,0,6,6,0,2.0,2.0,0.0,1,1,0,0.3,0.3,0.0,2,2,0,1,1,0,WWD,2025-07-27 14:09:22.490078
560,2,2020,Slavia Praha,2,1,1,0,0,0,1,1,0,1,0,1,1,0,1,0.5,0.0,1.0,4,0,4,2.0,0.0,4.0,1,1,0,1,1,0,DL,2025-07-27 14:09:22.490154
49,2,2020,Chelsea,13,6,7,9,3,6,3,2,1,1,1,0,23,8,15,1.8,1.3,2.1,4,2,2,0.3,0.3,0.3,9,4,5,2,2,0,DWWWWDWWWLDWW,2025-07-27 14:09:22.490229
562,2,2020,FC Astana,1,0,1,0,0,0,0,0,0,1,0,1,3,0,3,3.0,0.0,3.0,6,0,6,6.0,0.0,6.0,0,0,0,0,0,0,L,2025-07-27 14:09:22.490310
50,2,2020,Manchester City,13,7,6,11,6,5,1,0,1,1,1,0,25,15,10,1.9,2.1,1.7,5,3,2,0.4,0.4,0.3,8,4,4,2,1,1,WWWWDWWWWWWWL,2025-07-27 14:09:22.490395
564,2,2020,Istanbul Basaksehir,6,3,3,1,1,0,0,0,0,5,2,3,7,5,2,1.2,1.7,0.7,18,7,11,3.0,2.3,3.7,0,0,0,2,1,1,LLWLLL,2025-07-27 14:09:22.490472
565,2,2020,BSC Young Boys,2,1,1,1,1,0,0,0,0,1,0,1,3,3,0,1.5,3.0,0.0,4,1,3,2.0,1.0,3.0,0,0,0,1,0,1,WL,2025-07-27 14:09:22.490557
566,2,2020,Ludogorets,2,1,1,1,0,1,0,0,0,1,1,0,3,0,3,1.5,0.0,3.0,2,1,1,1.0,1.0,1.0,0,0,0,1,1,0,WL,2025-07-27 14:09:22.490632
567,2,2020,Plzen,1,0,1,0,0,0,0,0,0,1,0,1,1,0,1,1.0,0.0,1.0,3,0,3,3.0,0.0,3.0,0,0,0,0,0,0,L,2025-07-27 14:09:22.490714
568,2,2020,Sheriff Tiraspol,2,1,1,1,1,0,0,0,0,1,0,1,3,2,1,1.5,2.0,1.0,2,0,2,1.0,0.0,2.0,1,1,0,0,0,0,WL,2025-07-27 14:09:22.490792
569,2,2020,Club Brugge KV,6,3,3,2,1,1,2,1,1,2,1,1,8,4,4,1.3,1.3,1.3,10,4,6,1.7,1.3,2.0,1,1,0,2,1,1,WDLLWD,2025-07-27 14:09:22.490856
571,2,2020,Red Bull Salzburg,8,4,4,3,1,2,1,1,0,4,2,2,15,7,8,1.9,1.8,2.0,19,11,8,2.4,2.8,2.0,0,0,0,1,1,0,WWDLLLWL,2025-07-27 14:09:22.490911
572,2,2020,Dynamo Kyiv,9,5,4,4,3,1,1,0,1,4,2,2,11,6,5,1.2,1.2,1.3,14,6,8,1.6,1.2,2.0,3,3,0,3,2,1,WWWLDLLLW,2025-07-27 14:09:22.490966
579,2,2020,Buducnost Podgorica,1,1,0,0,0,0,0,0,0,1,1,0,1,1,0,1.0,1.0,0.0,3,3,0,3.0,3.0,0.0,0,0,0,0,0,0,L,2025-07-27 14:09:22.491015
583,2,2020,Linfield,3,0,3,2,0,2,0,0,0,1,0,1,5,0,5,1.7,0.0,1.7,1,0,1,0.3,0.0,0.3,2,0,2,1,0,1,WWL,2025-07-27 14:09:22.491065
584,2,2020,Dundalk,1,0,1,0,0,0,0,0,0,1,0,1,0,0,0,0.0,0.0,0.0,3,0,3,3.0,0.0,3.0,0,0,0,1,0,1,L,2025-07-27 14:09:22.491112
81,2,2020,Marseille,6,3,3,1,1,0,0,0,0,5,2,3,2,2,0,0.3,0.7,0.0,13,6,7,2.2,2.0,2.3,0,0,0,5,2,3,LLLLWL,2025-07-27 14:09:22.491170
596,2,2020,Zenit,6,3,3,0,0,0,1,1,0,5,2,3,4,3,1,0.7,1.0,0.3,13,5,8,2.2,1.7,2.7,0,0,0,2,0,2,LLDLLL,2025-07-27 14:09:22.491221
85,2,2020,Paris Saint Germain,12,6,6,6,2,4,1,1,0,5,3,2,22,9,13,1.8,1.5,2.2,15,7,8,1.3,1.2,1.3,2,1,1,2,1,1,LWLWWWWDWLLL,2025-07-27 14:09:22.491270
598,2,2020,FK Crvena Zvezda,3,1,2,2,1,1,1,0,1,0,0,0,7,5,2,2.3,5.0,1.0,1,0,1,0.3,0.0,0.5,2,1,1,0,0,0,WWD,2025-07-27 14:09:22.491317
597,2,2020,Lokomotiv,6,3,3,0,0,0,3,1,2,3,2,1,5,3,2,0.8,1.0,0.7,10,6,4,1.7,2.0,1.3,1,0,1,2,0,2,DLDDLL,2025-07-27 14:09:22.491364
604,2,2020,Maccabi Tel Aviv,5,3,2,3,2,1,0,0,0,2,1,1,8,4,4,1.6,1.3,2.0,5,2,3,1.0,0.7,1.5,3,2,1,0,0,0,WWWLL,2025-07-27 14:09:22.491426
94,2,2020,Rennes,6,3,3,0,0,0,1,1,0,5,2,3,3,3,0,0.5,1.0,0.0,11,6,5,1.8,2.0,1.7,0,0,0,3,0,3,DLLLLL,2025-07-27 14:09:22.491496
3683,2,2020,Ararat-Armenia,1,1,0,0,0,0,0,0,0,1,1,0,0,0,0,0.0,0.0,0.0,1,1,0,1.0,1.0,0.0,0,0,0,1,1,0,L,2025-07-27 14:09:22.491568
612,2,2020,Suduva Marijampole,2,1,1,0,0,0,1,0,1,1,1,0,1,0,1,0.5,0.0,1.0,4,3,1,2.0,3.0,1.0,0,0,0,1,1,0,DL,2025-07-27 14:09:22.491651
619,2,2020,PAOK,4,3,1,2,2,0,0,0,0,2,1,1,7,6,1,1.8,2.0,1.0,6,4,2,1.5,1.3,2.0,0,0,0,0,0,0,WWLL,2025-07-27 14:09:22.491737
620,2,2020,Dinamo Zagreb,2,0,2,0,0,0,1,0,1,1,0,1,3,0,3,1.5,0.0,1.5,4,0,4,2.0,0.0,2.0,0,0,0,0,0,0,DL,2025-07-27 14:09:22.491802
621,2,2020,FC Krasnodar,8,4,4,3,2,1,2,0,2,3,2,1,10,4,6,1.3,1.0,1.5,13,7,6,1.6,1.8,1.5,1,1,0,1,1,0,WWDLLLWD,2025-07-27 14:09:22.491879
626,2,2020,Fola Esch,1,0,1,0,0,0,0,0,0,1,0,1,0,0,0,0.0,0.0,0.0,2,0,2,2.0,0.0,2.0,0,0,0,1,0,1,L,2025-07-27 14:09:22.491981
631,2,2020,Gent,3,2,1,1,1,0,0,0,0,2,1,1,3,3,0,1.0,1.5,0.0,6,3,3,2.0,1.5,3.0,0,0,0,1,0,1,WLL,2025-07-27 14:09:22.492075
651,2,2020,Ferencvarosi TC,11,6,5,3,2,1,3,2,1,5,2,3,14,7,7,1.3,1.2,1.4,22,10,12,2.0,1.7,2.4,2,2,0,3,2,1,WWWDDLDLLLL,2025-07-27 14:09:22.492156
1165,2,2020,KuPS,1,0,1,0,0,0,0,0,0,1,0,1,0,0,0,0.0,0.0,0.0,5,0,5,5.0,0.0,5.0,0,0,0,1,0,1,L,2025-07-27 14:09:22.492214
656,2,2020,Slovan Bratislava,1,0,1,0,0,0,0,0,0,1,0,1,0,0,0,0.0,0.0,0.0,3,0,3,3.0,0.0,3.0,0,0,0,1,0,1,L,2025-07-27 14:09:22.492275
157,2,2020,Bayern München,10,5,5,8,4,4,1,0,1,1,1,0,27,13,14,2.7,2.6,2.8,10,5,5,1.0,1.0,1.0,3,2,1,0,0,0,WWWWDWWWLW,2025-07-27 14:09:22.492331
163,2,2020,Borussia Mönchengladbach,8,4,4,2,1,1,2,1,1,4,2,2,16,8,8,2.0,2.0,2.0,13,7,6,1.6,1.8,1.5,2,1,1,3,1,2,DDWWLLLL,2025-07-27 14:09:22.492392
165,2,2020,Borussia Dortmund,10,5,5,5,2,3,2,2,0,3,1,2,19,9,10,1.9,1.8,2.0,13,5,8,1.3,1.0,1.6,3,2,1,0,0,0,LWWWDWWDLL,2025-07-27 14:09:22.492449
679,2,2020,FK Sarajevo,2,0,2,1,0,1,0,0,0,1,0,1,3,0,3,1.5,0.0,1.5,2,0,2,1.0,0.0,1.0,1,0,1,0,0,0,WL,2025-07-27 14:09:22.492508
173,2,2020,RB Leipzig,8,4,4,4,3,1,0,0,0,4,1,3,11,7,4,1.4,1.8,1.0,16,5,11,2.0,1.3,2.8,1,1,0,4,1,3,WLWLWWLL,2025-07-27 14:09:22.492564
687,2,2020,Flora Tallinn,1,1,0,0,0,0,1,1,0,0,0,0,1,1,0,1.0,1.0,0.0,1,1,0,1.0,1.0,0.0,0,0,0,0,0,0,D,2025-07-27 14:09:22.492624
694,2,2020,Tirana,2,1,1,1,0,1,0,0,0,1,1,0,2,0,2,1.0,0.0,2.0,1,1,0,0.5,1.0,0.0,1,0,1,1,1,0,WL,2025-07-27 14:09:22.492683
701,2,2020,KI Klaksvik,2,1,1,1,1,0,0,0,0,1,0,1,4,3,1,2.0,3.0,1.0,3,0,3,1.5,0.0,3.0,1,1,0,0,0,0,WL,2025-07-27 14:09:22.492743
194,2,2020,Ajax,6,3,3,2,1,1,1,0,1,3,2,1,7,3,4,1.2,1.0,1.3,7,3,4,1.2,1.0,1.3,0,0,0,3,2,1,LDWWLL,2025-07-27 14:09:22.492802
2246,2,2020,CFR 1907 Cluj,2,1,1,1,0,1,1,1,0,0,0,0,4,2,2,2.0,2.0,2.0,2,2,0,1.0,2.0,0.0,1,0,1,0,0,0,WD,2025-07-27 14:09:22.492863
201,2,2020,AZ Alkmaar,2,1,1,1,1,0,0,0,0,1,0,1,3,3,0,1.5,3.0,0.0,3,1,2,1.5,1.0,2.0,0,0,0,1,0,1,WL,2025-07-27 14:09:22.492931
211,2,2020,Benfica,1,0,1,0,0,0,0,0,0,1,0,1,1,0,1,1.0,0.0,1.0,2,0,2,2.0,0.0,2.0,0,0,0,0,0,0,L,2025-07-27 14:09:22.493002
2260,2,2020,Tre Fiori,1,1,0,0,0,0,0,0,0,1,1,0,0,0,0,0.0,0.0,0.0,2,2,0,2.0,2.0,0.0,0,0,0,1,1,0,L,2025-07-27 14:09:22.493055
212,2,2020,FC Porto,10,5,5,6,3,3,1,1,0,3,1,2,15,7,8,1.5,1.4,1.6,9,3,6,0.9,0.6,1.2,6,3,3,2,2,0,LWWWDWWLLW,2025-07-27 14:09:22.493120
2262,2,2020,Dinamo Tbilisi,1,1,0,0,0,0,0,0,0,1,1,0,0,0,0,0.0,0.0,0.0,2,2,0,2.0,2.0,0.0,0,0,0,1,1,0,L,2025-07-27 14:09:22.493176
4331,2,2020,Sileks,1,0,1,0,0,0,0,0,0,1,0,1,0,0,0,0.0,0.0,0.0,4,0,4,4.0,0.0,4.0,0,0,0,1,0,1,L,2025-07-27 14:09:22.493231
247,2,2020,Celtic,2,2,0,1,1,0,0,0,0,1,1,0,7,7,0,3.5,3.5,0.0,2,2,0,1.0,1.0,0.0,1,1,0,0,0,0,WL,2025-07-27 14:09:22.493291
4360,2,2020,Celje,2,2,0,1,1,0,0,0,0,1,1,0,4,4,0,2.0,2.0,0.0,2,2,0,1.0,1.0,0.0,1,1,0,0,0,0,WL,2025-07-27 14:09:22.493350
781,2,2020,Rapid Vienna,2,0,2,1,0,1,0,0,0,1,0,1,2,0,2,1.0,0.0,1.0,2,0,2,1.0,0.0,1.0,1,0,1,0,0,0,WL,2025-07-27 14:09:22.493400
3342,2,2020,Inter Club d'Escaldes,1,0,1,0,0,0,0,0,0,1,0,1,1,0,1,1.0,0.0,1.0,2,0,2,2.0,0.0,2.0,0,0,0,0,0,0,L,2025-07-27 14:09:22.493457
271,2,2020,KR Reykjavik,1,0,1,0,0,0,0,0,0,1,0,1,0,0,0,0.0,0.0,0.0,6,0,6,6.0,0.0,6.0,0,0,0,1,0,1,L,2025-07-27 14:09:22.493514
329,2,2020,Molde,5,2,3,2,1,1,3,1,2,0,0,0,10,8,2,2.0,4.0,0.7,4,3,1,0.8,1.5,0.3,3,1,2,2,0,2,WWDDD,2025-07-27 14:09:22.493566
3402,2,2020,Omonia Nicosia,5,2,3,2,0,2,2,2,0,1,0,1,4,1,3,0.8,0.5,1.0,3,1,2,0.6,0.5,0.7,3,1,2,2,1,1,WWDLD,2025-07-27 14:09:22.493616
339,2,2020,Legia Warszawa,2,2,0,1,1,0,0,0,0,1,1,0,1,1,0,0.5,0.5,0.0,2,2,0,1.0,1.0,0.0,1,1,0,1,1,0,WL,2025-07-27 14:09:22.493677
357,2,2020,GAP Connah S Quay FC,1,1,0,0,0,0,0,0,0,1,1,0,0,0,0,0.0,0.0,0.0,2,2,0,2.0,2.0,0.0,0,0,0,1,1,0,L,2025-07-27 14:09:22.493761
364,2,2020,Djurgardens IF,1,0,1,0,0,0,0,0,0,1,0,1,0,0,0,0.0,0.0,0.0,2,0,2,2.0,0.0,2.0,0,0,0,1,0,1,L,2025-07-27 14:09:22.493844
386,2,2020,Dinamo Brest,3,2,1,2,2,0,0,0,0,1,0,1,8,8,0,2.7,4.0,0.0,5,4,1,1.7,2.0,1.0,0,0,0,1,0,1,WWL,2025-07-27 14:09:22.493903
10124,2,2020,Riga,1,0,1,0,0,0,0,0,0,1,0,1,0,0,0,0.0,0.0,0.0,2,0,2,2.0,0.0,2.0,0,0,0,1,0,1,L,2025-07-27 14:09:22.493967
10125,2,2020,Europa,1,0,1,0,0,0,0,0,0,1,0,1,0,0,0,0.0,0.0,0.0,5,0,5,5.0,0.0,5.0,0,0,0,1,0,1,L,2025-07-27 14:09:22.494027
397,2,2020,FC Midtjylland,10,5,5,3,2,1,3,1,2,4,2,2,12,9,3,1.2,1.8,0.6,14,8,6,1.4,1.6,1.2,3,1,2,3,1,2,WWDWLLLLDD,2025-07-27 14:09:22.494081
14281,2,2020,Drita,2,2,0,1,1,0,0,0,0,1,1,0,2,2,0,1.0,1.0,0.0,4,4,0,2.0,2.0,0.0,0,0,0,1,1,0,WL,2025-07-27 14:09:22.494131
487,2,2020,Lazio,8,4,4,2,2,0,4,1,3,2,1,1,13,9,4,1.6,2.3,1.0,13,8,5,1.6,2.0,1.3,0,0,0,0,0,0,WDDWDDLL,2025-07-27 14:09:22.494194
496,2,2020,Juventus,8,4,4,6,3,3,0,0,0,2,1,1,18,8,10,2.3,2.0,2.5,8,5,3,1.0,1.3,0.8,3,1,2,1,1,0,WLWWWWLW,2025-07-27 14:09:22.494263
499,2,2020,Atalanta,8,4,4,3,0,3,2,2,0,3,2,1,11,3,8,1.4,0.8,2.0,12,9,3,1.5,2.3,0.8,3,0,3,2,2,0,WDLWDWLL,2025-07-27 14:09:22.494320
505,2,2020,Inter,6,3,3,1,0,1,3,2,1,2,1,1,7,2,5,1.2,0.7,1.7,9,4,5,1.5,1.3,1.7,2,1,1,3,2,1,DDLLWD,2025-07-27 14:09:22.494372
1017,2,2020,NK Lokomotiva Zagreb,1,1,0,0,0,0,0,0,0,1,1,0,0,0,0,0.0,0.0,0.0,1,1,0,1.0,1.0,0.0,0,0,0,1,1,0,L,2025-07-27 14:09:22.494438
529,2,2021,Barcelona,6,3,3,2,1,1,1,1,0,3,1,2,2,1,1,0.3,0.3,0.3,9,3,6,1.5,1.0,2.0,3,2,1,4,2,2,LLWWDL,2025-07-27 14:09:22.494501
530,2,2021,Atletico Madrid,10,5,5,3,0,3,3,3,0,4,2,2,9,3,6,0.9,0.6,1.2,10,5,5,1.0,1.0,1.0,3,2,1,5,3,2,DWLLLWDWLD,2025-07-27 14:09:22.494566
533,2,2021,Villarreal,12,6,6,5,2,3,3,2,1,4,2,2,20,8,12,1.7,1.3,2.0,16,8,8,1.3,1.3,1.3,3,2,1,2,1,1,DLWWLWDWWDLL,2025-07-27 14:09:22.494631
536,2,2021,Sevilla,6,3,3,1,1,0,3,1,2,2,1,1,5,4,1,0.8,1.3,0.3,5,3,2,0.8,1.0,0.7,2,1,1,2,0,2,DDDLWL,2025-07-27 14:09:22.494695
541,2,2021,Real Madrid,13,6,7,9,4,5,0,0,0,4,2,2,29,13,16,2.2,2.2,2.3,14,8,6,1.1,1.3,0.9,5,1,4,1,0,1,WLWWWWLWWLLWW,2025-07-27 14:09:22.494759
33,2,2021,Manchester United,8,4,4,3,2,1,3,1,2,2,1,1,12,6,6,1.5,1.5,1.5,10,5,5,1.3,1.3,1.3,1,0,1,1,1,0,LWWDWDDL,2025-07-27 14:09:22.494823
4133,2,2021,HB,1,1,0,0,0,0,0,0,0,1,1,0,0,0,0,0.0,0.0,0.0,1,1,0,1.0,1.0,0.0,0,0,0,1,1,0,L,2025-07-27 14:09:22.494893
550,2,2021,Shakhtar Donetsk,10,5,5,3,1,2,3,3,0,4,1,3,9,5,4,0.9,1.0,0.8,16,9,7,1.6,1.8,1.4,2,1,1,4,2,2,WWWDLDLLLD,2025-07-27 14:09:22.494972
549,2,2021,Besiktas,6,3,3,0,0,0,0,0,0,6,3,3,3,3,0,0.5,1.0,0.0,19,8,11,3.2,2.7,3.7,0,0,0,3,0,3,LLLLLL,2025-07-27 14:09:22.495038
40,2,2021,Liverpool,13,7,6,10,4,6,1,1,0,2,2,0,30,12,18,2.3,1.7,3.0,14,7,7,1.1,1.0,1.2,4,3,1,2,2,0,WWWWWWWLWDWWL,2025-07-27 14:09:22.495103
553,2,2021,Olympiakos Piraeus,4,2,2,2,1,1,2,1,1,0,0,0,5,2,3,1.3,1.0,1.5,3,1,2,0.8,0.5,1.0,2,1,1,0,0,0,WWDD,2025-07-27 14:09:22.495175
558,2,2021,Spartak Moscow,2,1,1,0,0,0,0,0,0,2,1,1,0,0,0,0.0,0.0,0.0,4,2,2,2.0,2.0,2.0,0,0,0,2,1,1,LL,2025-07-27 14:09:22.495232
560,2,2021,Slavia Praha,2,1,1,1,1,0,0,0,0,1,0,1,1,1,0,0.5,1.0,0.0,2,0,2,1.0,0.0,2.0,1,1,0,1,0,1,LW,2025-07-27 14:09:22.495290
49,2,2021,Chelsea,10,5,5,7,4,3,1,0,1,2,1,1,21,12,9,2.1,2.4,1.8,10,3,7,1.0,0.6,1.4,5,4,1,1,0,1,WLWWWDWWLW,2025-07-27 14:09:22.495353
50,2,2021,Manchester City,12,6,6,7,5,2,2,1,1,3,0,3,29,17,12,2.4,2.8,2.0,16,8,8,1.3,1.3,1.3,4,2,2,3,1,2,WLWWWLWDWDWL,2025-07-27 14:09:22.495418
565,2,2021,BSC Young Boys,12,6,6,5,4,1,4,1,3,3,1,2,20,15,5,1.7,2.5,0.8,20,13,7,1.7,2.2,1.2,1,0,1,3,0,3,DWDWWWWLLLDD,2025-07-27 14:09:22.495484
566,2,2021,Ludogorets,8,4,4,4,3,1,3,1,2,1,0,1,10,8,2,1.3,2.0,0.5,7,4,3,0.9,1.0,0.8,3,1,2,2,0,2,WWDWDDLW,2025-07-27 14:09:22.495561
568,2,2021,Sheriff Tiraspol,14,7,7,8,5,3,3,0,3,3,2,1,21,11,10,1.5,1.6,1.4,13,7,6,0.9,1.0,0.9,7,4,3,2,1,1,WWWWDWWDWWLLLD,2025-07-27 14:09:22.495632
569,2,2021,Club Brugge KV,6,3,3,1,0,1,1,1,0,4,2,2,6,2,4,1.0,0.7,1.3,20,11,9,3.3,3.7,3.0,0,0,0,1,1,0,DWLLLL,2025-07-27 14:09:22.495687
571,2,2021,Red Bull Salzburg,10,5,5,5,4,1,2,1,1,3,0,3,14,9,5,1.4,1.8,1.0,16,4,12,1.6,0.8,2.4,1,1,0,1,0,1,WWDWWLLWDL,2025-07-27 14:09:22.495743
572,2,2021,Dynamo Kyiv,6,3,3,0,0,0,1,1,0,5,2,3,1,1,0,0.2,0.3,0.0,11,3,8,1.8,1.0,2.7,1,1,0,5,2,3,DLLLLL,2025-07-27 14:09:22.495831
579,2,2021,Buducnost Podgorica,2,1,1,0,0,0,0,0,0,2,1,1,1,0,1,0.5,0.0,1.0,7,4,3,3.5,4.0,3.0,0,0,0,1,1,0,LL,2025-07-27 14:09:22.495918
582,2,2021,Alashkert,4,2,2,1,1,0,1,0,1,2,1,1,4,1,3,1.0,0.5,1.5,6,1,5,1.5,0.5,2.5,1,1,0,1,1,0,DWLL,2025-07-27 14:09:22.495997
583,2,2021,Linfield,2,1,1,0,0,0,0,0,0,2,1,1,2,1,1,1.0,1.0,1.0,5,2,3,2.5,2.0,3.0,0,0,0,0,0,0,LL,2025-07-27 14:09:22.496063
586,2,2021,FK Zalgiris Vilnius,4,2,2,2,1,1,0,0,0,2,1,1,6,4,2,1.5,2.0,1.0,7,4,3,1.8,2.0,1.5,0,0,0,1,0,1,WWLL,2025-07-27 14:09:22.496122
79,2,2021,Lille,8,4,4,3,1,2,2,2,0,3,1,2,8,2,6,1.0,0.5,1.5,8,2,6,1.0,0.5,1.5,3,3,0,3,2,1,DLDWWWLL,2025-07-27 14:09:22.496207
596,2,2021,Zenit,6,3,3,1,1,0,2,1,1,3,1,2,10,7,3,1.7,2.3,1.0,10,4,6,1.7,1.3,2.0,1,1,0,2,1,1,LWLLDD,2025-07-27 14:09:22.496292
85,2,2021,Paris Saint Germain,8,4,4,4,4,0,2,0,2,2,0,2,15,10,5,1.9,2.5,1.3,11,3,8,1.4,0.8,2.0,2,2,0,0,0,0,DWWDLWWL,2025-07-27 14:09:22.496370
598,2,2021,FK Crvena Zvezda,4,2,2,1,1,0,1,1,0,2,0,2,7,6,1,1.8,3.0,0.5,4,1,3,1.0,0.5,1.5,1,1,0,1,0,1,LWDL,2025-07-27 14:09:22.496461
91,2,2021,Monaco,4,2,2,2,1,1,1,0,1,1,1,0,7,3,4,1.8,1.5,2.0,4,2,2,1.0,1.0,1.0,1,0,1,1,1,0,WWLD,2025-07-27 14:09:22.496550
609,2,2021,Shkendija,2,1,1,0,0,0,0,0,0,2,1,1,0,0,0,0.0,0.0,0.0,6,1,5,3.0,1.0,5.0,0,0,0,2,1,1,LL,2025-07-27 14:09:22.496636
4195,2,2021,Maccabi Haifa,2,1,1,0,0,0,1,1,0,1,0,1,1,1,0,0.5,1.0,0.0,3,1,2,1.5,1.0,2.0,0,0,0,1,0,1,DL,2025-07-27 14:09:22.496730
4197,2,2021,Mura,4,2,2,2,1,1,1,1,0,1,0,1,7,5,2,1.8,2.5,1.0,3,0,3,0.8,0.0,1.5,3,2,1,1,1,0,WWDL,2025-07-27 14:09:22.496817
620,2,2021,Dinamo Zagreb,8,4,4,5,2,3,2,2,0,1,0,1,10,6,4,1.3,1.5,1.0,6,3,3,0.8,0.8,0.8,5,2,3,2,1,1,WWWWDWLD,2025-07-27 14:09:22.496900
626,2,2021,Fola Esch,2,1,1,0,0,0,1,1,0,1,0,1,2,2,0,1.0,2.0,0.0,7,2,5,3.5,2.0,5.0,0,0,0,1,0,1,DL,2025-07-27 14:09:22.496985
628,2,2021,Sparta Praha,4,2,2,1,1,0,0,0,0,3,1,2,4,2,2,1.0,1.0,1.0,7,2,5,1.8,1.0,2.5,1,1,0,1,1,0,LWLL,2025-07-27 14:09:22.497072
645,2,2021,Galatasaray,2,1,1,0,0,0,0,0,0,2,1,1,2,1,1,1.0,1.0,1.0,7,2,5,3.5,2.0,5.0,0,0,0,0,0,0,LL,2025-07-27 14:09:22.497159
649,2,2021,HJK helsinki,4,2,2,2,1,1,1,1,0,1,0,1,10,5,5,2.5,2.5,2.5,5,3,2,1.3,1.5,1.0,1,0,1,0,0,0,WWLD,2025-07-27 14:09:22.497236
651,2,2021,Ferencvarosi TC,8,4,4,5,3,2,0,0,0,3,1,2,17,9,8,2.1,2.3,2.0,9,3,6,1.1,0.8,1.5,3,3,0,1,0,1,WWWWWLLL,2025-07-27 14:09:22.497325
652,2,2021,Shamrock Rovers,2,1,1,1,1,0,0,0,0,1,0,1,2,2,0,1.0,2.0,0.0,3,1,2,1.5,1.0,2.0,0,0,0,1,0,1,LW,2025-07-27 14:09:22.497397
656,2,2021,Slovan Bratislava,4,2,2,1,1,0,1,1,0,2,0,2,5,2,3,1.3,1.0,1.5,5,0,5,1.3,0.0,2.5,2,2,0,1,1,0,WLDL,2025-07-27 14:09:22.497477
664,2,2021,Kairat Almaty,4,2,2,2,2,0,1,0,1,1,0,1,5,4,1,1.3,2.0,0.5,7,1,6,1.8,0.5,3.0,1,1,0,1,0,1,DWWL,2025-07-27 14:09:22.497548
667,2,2021,Lincoln Red Imps FC,4,2,2,1,1,0,1,0,1,2,1,1,8,6,2,2.0,3.0,1.0,6,2,4,1.5,1.0,2.0,1,1,0,1,0,1,DWLL,2025-07-27 14:09:22.497614
157,2,2021,Bayern München,10,5,5,7,4,3,2,1,1,1,0,1,31,21,10,3.1,4.2,2.0,7,4,3,0.7,0.8,0.6,4,2,2,1,0,1,WWWWWWDWLD,2025-07-27 14:09:22.497686
672,2,2021,Folgore,1,1,0,0,0,0,0,0,0,1,1,0,0,0,0,0.0,0.0,0.0,2,2,0,2.0,2.0,0.0,0,0,0,1,1,0,L,2025-07-27 14:09:22.497746
161,2,2021,VfL Wolfsburg,6,3,3,1,1,0,2,1,1,3,1,2,5,4,1,0.8,1.3,0.3,10,5,5,1.7,1.7,1.7,1,0,1,2,0,2,DDLWLL,2025-07-27 14:09:22.497831
165,2,2021,Borussia Dortmund,6,3,3,3,2,1,0,0,0,3,1,2,10,7,3,1.7,2.3,1.0,11,3,8,1.8,1.0,2.7,2,2,0,1,0,1,WWLLLW,2025-07-27 14:09:22.497920
680,2,2021,Prishtina,4,2,2,2,1,1,0,0,0,2,1,1,5,3,2,1.3,1.5,1.0,6,3,3,1.5,1.5,1.5,2,1,1,1,0,1,WWLL,2025-07-27 14:09:22.497988
173,2,2021,RB Leipzig,6,3,3,2,1,1,1,1,0,3,1,2,15,5,10,2.5,1.7,3.3,14,5,9,2.3,1.7,3.0,1,0,1,0,0,0,LLLDWW,2025-07-27 14:09:22.498074
687,2,2021,Flora Tallinn,4,2,2,2,1,1,0,0,0,2,1,1,6,2,4,1.5,1.0,2.0,3,1,2,0.8,0.5,1.0,2,1,1,1,1,0,WWLL,2025-07-27 14:09:22.498160
194,2,2021,Ajax,8,4,4,6,3,3,1,0,1,1,1,0,22,10,12,2.8,2.5,3.0,8,3,5,1.0,0.8,1.3,2,2,0,1,1,0,WWWWWWDL,2025-07-27 14:09:22.498251
197,2,2021,PSV Eindhoven,6,3,3,4,2,2,1,1,0,1,0,1,12,8,4,2.0,2.7,1.3,4,1,3,0.7,0.3,1.0,3,2,1,1,1,0,WWWWLD,2025-07-27 14:09:22.498332
2246,2,2021,CFR 1907 Cluj,6,3,3,3,2,1,1,1,0,2,0,2,10,6,4,1.7,2.0,1.3,8,2,6,1.3,0.7,2.0,1,1,0,0,0,0,WLWWDL,2025-07-27 14:09:22.498410
211,2,2021,Benfica,14,7,7,6,4,2,5,1,4,3,2,1,20,12,8,1.4,1.7,1.1,18,10,8,1.3,1.4,1.1,8,3,5,4,1,3,WWWDDWLLDWDWLD,2025-07-27 14:09:22.498495
212,2,2021,FC Porto,6,3,3,1,1,0,2,0,2,3,2,1,4,3,1,0.7,1.0,0.3,11,8,3,1.8,2.7,1.0,2,1,1,2,0,2,DLWDLL,2025-07-27 14:09:22.498569
2262,2,2021,Dinamo Tbilisi,2,1,1,0,0,0,0,0,0,2,1,1,2,1,1,1.0,1.0,1.0,4,2,2,2.0,2.0,2.0,0,0,0,0,0,0,LL,2025-07-27 14:09:22.498642
2270,2,2021,Neftchi Baku,4,2,2,2,1,1,0,0,0,2,1,1,4,2,2,1.0,1.0,1.0,4,2,2,1.0,1.0,1.0,0,0,0,2,1,1,WWLL,2025-07-27 14:09:22.498715
228,2,2021,Sporting CP,8,4,4,3,2,1,1,0,1,4,2,2,14,8,6,1.8,2.0,1.5,17,11,6,2.1,2.8,1.5,2,1,1,3,1,2,LLWWWLLD,2025-07-27 14:09:22.498797
742,2,2021,Genk,2,1,1,0,0,0,0,0,0,2,1,1,2,1,1,1.0,1.0,1.0,4,2,2,2.0,2.0,2.0,0,0,0,0,0,0,LL,2025-07-27 14:09:22.498874
247,2,2021,Celtic,2,1,1,0,0,0,1,1,0,1,0,1,2,1,1,1.0,1.0,1.0,3,1,2,1.5,1.0,2.0,0,0,0,0,0,0,DL,2025-07-27 14:09:22.498953
3320,2,2021,Teuta Durrës,2,1,1,0,0,0,0,0,0,2,1,1,0,0,0,0.0,0.0,0.0,5,4,1,2.5,4.0,1.0,0,0,0,2,1,1,LL,2025-07-27 14:09:22.499032
257,2,2021,Rangers,2,1,1,0,0,0,0,0,0,2,1,1,2,1,1,1.0,1.0,1.0,4,2,2,2.0,2.0,2.0,0,0,0,0,0,0,LL,2025-07-27 14:09:22.499112
781,2,2021,Rapid Vienna,2,1,1,1,1,0,0,0,0,1,0,1,2,2,0,1.0,2.0,0.0,3,1,2,1.5,1.0,2.0,0,0,0,1,0,1,WL,2025-07-27 14:09:22.499199
3342,2,2021,Inter Club d'Escaldes,2,0,2,1,0,1,0,0,0,1,0,1,1,0,1,0.5,0.0,0.5,2,0,2,1.0,0.0,1.0,1,0,1,1,0,1,WL,2025-07-27 14:09:22.499279
274,2,2021,Valur Reykjavik,2,1,1,0,0,0,0,0,0,2,1,1,2,0,2,1.0,0.0,2.0,5,2,3,2.5,2.0,3.0,0,0,0,1,1,0,LL,2025-07-27 14:09:22.499370
3364,2,2021,Borac Banja Luka,2,1,1,1,1,0,0,0,0,1,0,1,3,2,1,1.5,2.0,1.0,4,1,3,2.0,1.0,3.0,0,0,0,0,0,0,LW,2025-07-27 14:09:22.499449
3884,2,2021,Hibernians,2,1,1,0,0,0,0,0,0,2,1,1,0,0,0,0.0,0.0,0.0,5,3,2,2.5,3.0,2.0,0,0,0,2,1,1,LL,2025-07-27 14:09:22.499530
327,2,2021,Bodo/Glimt,2,1,1,0,0,0,0,0,0,2,1,1,2,2,0,1.0,2.0,0.0,5,3,2,2.5,3.0,2.0,0,0,0,1,0,1,LL,2025-07-27 14:09:22.499606
3402,2,2021,Omonia Nicosia,2,1,1,0,0,0,0,0,0,2,1,1,0,0,0,0.0,0.0,0.0,3,1,2,1.5,1.0,2.0,0,0,0,2,1,1,LL,2025-07-27 14:09:22.499695
339,2,2021,Legia Warszawa,6,3,3,4,2,2,1,0,1,1,1,0,9,4,5,1.5,1.3,1.7,5,2,3,0.8,0.7,1.0,2,1,1,1,1,0,WWWWDL,2025-07-27 14:09:22.499770
357,2,2021,GAP Connah S Quay FC,2,1,1,0,0,0,1,1,0,1,0,1,2,2,0,1.0,2.0,0.0,3,2,1,1.5,2.0,1.0,0,0,0,1,0,1,DL,2025-07-27 14:09:22.499837
375,2,2021,Malmo FF,14,7,7,5,4,1,3,1,2,6,2,4,14,8,6,1.0,1.1,0.9,22,7,15,1.6,1.0,2.1,2,2,0,5,2,3,WDWDWWWLLLLLDL,2025-07-27 14:09:22.499900
392,2,2021,Shakhter Soligorsk,2,1,1,0,0,0,0,0,0,2,1,1,0,0,0,0.0,0.0,0.0,2,1,1,1.0,1.0,1.0,0,0,0,2,1,1,LL,2025-07-27 14:09:22.499999
10124,2,2021,Riga,2,1,1,0,0,0,1,1,0,1,0,1,1,1,0,0.5,1.0,0.0,2,1,1,1.0,1.0,1.0,0,0,0,1,0,1,LD,2025-07-27 14:09:22.500064
397,2,2021,FC Midtjylland,4,2,2,1,1,0,1,0,1,2,1,1,3,2,1,0.8,1.0,0.5,6,2,4,1.5,1.0,2.0,0,0,0,2,1,1,DWLL,2025-07-27 14:09:22.500135
407,2,2021,Brondby,2,1,1,0,0,0,0,0,0,2,1,1,2,1,1,1.0,1.0,1.0,4,2,2,2.0,2.0,2.0,0,0,0,0,0,0,LL,2025-07-27 14:09:22.500217
489,2,2021,AC Milan,6,3,3,1,0,1,1,1,0,4,2,2,6,3,3,1.0,1.0,1.0,9,5,4,1.5,1.7,1.3,1,0,1,1,0,1,LLLDWL,2025-07-27 14:09:22.500294
496,2,2021,Juventus,8,4,4,5,3,2,1,0,1,2,1,1,11,6,5,1.4,1.5,1.3,10,5,5,1.3,1.3,1.3,4,2,2,2,1,1,WWWWLWDL,2025-07-27 14:09:22.500389
499,2,2021,Atalanta,6,3,3,1,1,0,3,1,2,2,1,1,12,5,7,2.0,1.7,2.3,13,5,8,2.2,1.7,2.7,1,1,0,0,0,0,DWLDDL,2025-07-27 14:09:22.500479
505,2,2021,Inter,8,4,4,4,2,2,1,0,1,3,2,1,9,5,4,1.1,1.3,1.0,7,4,3,0.9,1.0,0.8,3,1,2,4,2,2,LDWWWLLW,2025-07-27 14:09:22.500569
529,2,2022,Barcelona,6,3,3,2,1,1,1,1,0,3,1,2,12,8,4,2.0,2.7,1.3,12,7,5,2.0,2.3,1.7,0,0,0,3,1,2,WLLDLW,2025-07-27 14:09:22.500650
530,2,2022,Atletico Madrid,6,3,3,1,1,0,2,2,0,3,0,3,5,4,1,0.8,1.3,0.3,9,3,6,1.5,1.0,2.0,1,1,0,3,1,2,WLLDDL,2025-07-27 14:09:22.500746
536,2,2022,Sevilla,6,3,3,1,1,0,2,0,2,3,2,1,6,4,2,1.0,1.3,0.7,12,8,4,2.0,2.7,1.3,2,1,1,2,1,1,LDLDWL,2025-07-27 14:09:22.500841
541,2,2022,Real Madrid,12,6,6,8,5,3,2,1,1,2,0,2,26,13,13,2.2,2.2,2.2,13,3,10,1.1,0.5,1.7,5,3,2,1,0,1,WWWDLWWWWWDL,2025-07-27 14:09:22.500930
550,2,2022,Shakhtar Donetsk,6,3,3,1,0,1,3,2,1,2,1,1,8,2,6,1.3,0.7,2.0,10,6,4,1.7,2.0,1.3,0,0,0,1,1,0,WDLDDL,2025-07-27 14:09:22.501015
552,2,2022,Maribor,4,2,2,1,0,1,2,2,0,1,0,1,2,0,2,0.5,0.0,1.0,1,0,1,0.3,0.0,0.5,3,2,1,3,2,1,DWDL,2025-07-27 14:09:22.501106
553,2,2022,Olympiakos Piraeus,2,1,1,0,0,0,1,0,1,1,1,0,1,0,1,0.5,0.0,1.0,5,4,1,2.5,4.0,1.0,0,0,0,1,1,0,DL,2025-07-27 14:09:22.501189
40,2,2022,Liverpool,8,4,4,5,3,2,0,0,0,3,1,2,19,8,11,2.4,2.0,2.8,12,6,6,1.5,1.5,1.5,3,2,1,1,0,1,LWWWWWLL,2025-07-27 14:09:22.501276
556,2,2022,Qarabag,8,4,4,3,2,1,3,2,1,2,0,2,15,9,6,1.9,2.3,1.5,10,4,6,1.3,1.0,1.5,1,1,0,2,1,1,LWWDDWDL,2025-07-27 14:09:22.501358
47,2,2022,Tottenham,8,4,4,3,2,1,3,2,1,2,0,2,8,6,2,1.0,1.5,0.5,7,3,4,0.9,0.8,1.0,3,2,1,4,1,3,WLDWDWLD,2025-07-27 14:09:22.501434
49,2,2022,Chelsea,10,5,5,5,3,2,1,1,0,4,1,3,12,8,4,1.2,1.6,0.8,9,4,5,0.9,0.8,1.0,3,2,1,4,1,3,LDWWWWLWLL,2025-07-27 14:09:22.501523
50,2,2022,Manchester City,13,7,6,8,7,1,5,0,5,0,0,0,32,25,7,2.5,3.6,1.2,5,2,3,0.4,0.3,0.5,8,5,3,2,0,2,WWWDDWDWWDDWW,2025-07-27 14:09:22.501615
566,2,2022,Ludogorets,6,3,3,3,2,1,0,0,0,3,1,2,10,6,4,1.7,2.0,1.3,8,2,6,1.3,0.7,2.0,3,2,1,0,0,0,WWWLLL,2025-07-27 14:09:22.501696
567,2,2022,Plzen,12,6,6,5,3,2,1,0,1,6,3,3,18,13,5,1.5,2.2,0.8,28,12,16,2.3,2.0,2.7,2,1,1,4,1,3,WWWWDWLLLLLL,2025-07-27 14:09:22.501755
568,2,2022,Sheriff Tiraspol,6,3,3,2,2,0,2,0,2,2,1,1,4,3,1,0.7,1.0,0.3,4,2,2,0.7,0.7,0.7,4,2,2,2,0,2,DWDWLL,2025-07-27 14:09:22.501822
569,2,2022,Club Brugge KV,8,4,4,3,2,1,2,0,2,3,2,1,8,3,5,1.0,0.8,1.3,11,6,5,1.4,1.5,1.3,5,2,3,4,2,2,WWWDLDLL,2025-07-27 14:09:22.501897
571,2,2022,Red Bull Salzburg,6,3,3,1,1,0,3,1,2,2,1,1,5,3,2,0.8,1.0,0.7,9,3,6,1.5,1.0,2.0,1,1,0,1,0,1,DDWDLL,2025-07-27 14:09:22.501985
572,2,2022,Dynamo Kyiv,6,3,3,3,1,2,1,1,0,2,1,1,5,1,4,0.8,0.3,1.3,7,2,5,1.2,0.7,1.7,2,2,0,3,2,1,DWWWLL,2025-07-27 14:09:22.502077
4160,2,2022,Rīgas FS,2,1,1,1,1,0,0,0,0,1,0,1,2,2,0,1.0,2.0,0.0,2,1,1,1.0,1.0,1.0,0,0,0,1,0,1,LW,2025-07-27 14:09:22.502167
578,2,2022,F91 Dudelange,4,2,2,3,1,2,0,0,0,1,1,0,5,2,3,1.3,1.0,1.5,5,4,1,1.3,2.0,0.5,2,1,1,0,0,0,WWWL,2025-07-27 14:09:22.502236
583,2,2022,Linfield,4,2,2,2,2,0,0,0,0,2,0,2,3,3,0,0.8,1.5,0.0,9,0,9,2.3,0.0,4.5,2,2,0,2,0,2,LWWL,2025-07-27 14:09:22.502303
586,2,2022,FK Zalgiris Vilnius,6,3,3,3,2,1,2,1,1,1,0,1,6,3,3,1.0,1.0,1.0,7,1,6,1.2,0.3,2.0,3,2,1,1,0,1,DWWWLD,2025-07-27 14:09:22.502395
588,2,2022,Zrinjski,2,1,1,0,0,0,1,1,0,1,0,1,0,0,0,0.0,0.0,0.0,1,0,1,0.5,0.0,1.0,1,1,0,2,1,1,DL,2025-07-27 14:09:22.502481
81,2,2022,Marseille,6,3,3,2,1,1,0,0,0,4,2,2,8,5,3,1.3,1.7,1.0,8,4,4,1.3,1.3,1.3,1,0,1,2,1,1,LLWWLL,2025-07-27 14:09:22.502583
85,2,2022,Paris Saint Germain,8,4,4,4,2,2,2,1,1,2,1,1,16,10,6,2.0,2.5,1.5,10,5,5,1.3,1.3,1.3,0,0,0,2,1,1,WWDDWWLL,2025-07-27 14:09:22.502675
598,2,2022,FK Crvena Zvezda,4,2,2,2,1,1,1,1,0,1,0,1,11,7,4,2.8,3.5,2.0,5,2,3,1.3,1.0,1.5,2,1,1,0,0,0,WWLD,2025-07-27 14:09:22.502751
602,2,2022,Apollon Limassol,2,1,1,1,1,0,0,0,0,1,0,1,2,2,0,1.0,2.0,0.0,4,0,4,2.0,0.0,4.0,1,1,0,1,0,1,LW,2025-07-27 14:09:22.502844
91,2,2022,Monaco,2,1,1,0,0,0,1,1,0,1,0,1,3,1,2,1.5,1.0,2.0,4,1,3,2.0,1.0,3.0,0,0,0,0,0,0,DL,2025-07-27 14:09:22.502950
4195,2,2022,Maccabi Haifa,12,6,6,4,3,1,2,1,1,6,2,4,21,12,9,1.8,2.0,1.5,28,12,16,2.3,2.0,2.7,3,2,1,2,0,2,DWWLWDLLLWLL,2025-07-27 14:09:22.503050
611,2,2022,Fenerbahce,2,1,1,0,0,0,1,0,1,1,1,0,1,1,0,0.5,1.0,0.0,2,2,0,1.0,2.0,0.0,1,0,1,1,0,1,DL,2025-07-27 14:09:22.503154
614,2,2022,AEK Larnaca,2,1,1,0,0,0,2,1,1,0,0,0,2,1,1,1.0,1.0,1.0,2,1,1,1.0,1.0,1.0,0,0,0,0,0,0,DD,2025-07-27 14:09:22.503253
620,2,2022,Dinamo Zagreb,12,6,6,5,3,2,2,2,0,5,1,4,17,12,5,1.4,2.0,0.8,18,10,8,1.5,1.7,1.3,2,1,1,3,1,2,DWWWLWWLLDLL,2025-07-27 14:09:22.503349
637,2,2022,Sturm Graz,2,1,1,0,0,0,0,0,0,2,1,1,1,1,0,0.5,1.0,0.0,3,2,1,1.5,2.0,1.0,0,0,0,1,0,1,LL,2025-07-27 14:09:22.503449
649,2,2022,HJK helsinki,4,2,2,1,1,0,0,0,0,3,1,2,3,2,1,0.8,1.0,0.5,9,2,7,2.3,1.0,3.5,1,1,0,1,0,1,WLLL,2025-07-27 14:09:22.503530
651,2,2022,Ferencvarosi TC,6,3,3,2,1,1,2,0,2,2,2,0,12,7,5,2.0,2.3,1.7,8,6,2,1.3,2.0,0.7,1,0,1,1,0,1,DWLWDL,2025-07-27 14:09:22.503614
652,2,2022,Shamrock Rovers,4,2,2,2,2,0,1,0,1,1,0,1,5,5,0,1.3,2.5,0.0,4,1,3,1.0,0.5,1.5,2,1,1,2,0,2,WDLW,2025-07-27 14:09:22.503705
656,2,2022,Slovan Bratislava,4,2,2,2,0,2,1,1,0,1,1,0,5,1,4,1.3,0.5,2.0,6,4,2,1.5,2.0,1.0,1,1,0,1,1,0,DWWL,2025-07-27 14:09:22.503797
667,2,2022,Lincoln Red Imps FC,2,1,1,1,1,0,0,0,0,1,0,1,2,2,0,1.0,2.0,0.0,3,0,3,1.5,0.0,3.0,1,1,0,1,0,1,LW,2025-07-27 14:09:22.503890
157,2,2022,Bayern München,10,5,5,8,4,4,1,1,0,1,0,1,22,12,10,2.2,2.4,2.0,6,1,5,0.6,0.2,1.0,7,4,3,1,0,1,WWWWWWWWLD,2025-07-27 14:09:22.503961
673,2,2022,Sutjeska,2,1,1,0,0,0,0,0,0,2,1,1,0,0,0,0.0,0.0,0.0,3,1,2,1.5,1.0,2.0,0,0,0,2,1,1,LL,2025-07-27 14:09:22.504019
165,2,2022,Borussia Dortmund,8,4,4,3,2,1,3,2,1,2,0,2,11,5,6,1.4,1.3,1.5,7,1,6,0.9,0.3,1.5,3,3,0,2,1,1,WLWDDDWL,2025-07-27 14:09:22.504086
168,2,2022,Bayer Leverkusen,6,3,3,1,1,0,2,1,1,3,1,2,4,2,2,0.7,0.7,0.7,8,3,5,1.3,1.0,1.7,2,2,0,4,2,2,LWLLDD,2025-07-27 14:09:22.504149
169,2,2022,Eintracht Frankfurt,8,4,4,3,1,2,1,1,0,4,2,2,7,2,5,0.9,0.5,1.3,13,6,7,1.6,1.5,1.8,2,1,1,4,3,1,LWDLWWLL,2025-07-27 14:09:22.504219
173,2,2022,RB Leipzig,8,4,4,4,2,2,1,1,0,3,1,2,14,8,6,1.8,2.0,1.5,17,8,9,2.1,2.0,2.3,2,0,2,2,0,2,LLWWWWDL,2025-07-27 14:09:22.504285
694,2,2022,Tirana,2,1,1,0,0,0,0,0,0,2,1,1,1,1,0,0.5,1.0,0.0,3,2,1,1.5,2.0,1.0,0,0,0,1,0,1,LL,2025-07-27 14:09:22.504346
701,2,2022,KI Klaksvik,2,1,1,1,1,0,0,0,0,1,0,1,3,3,0,1.5,3.0,0.0,4,1,3,2.0,1.0,3.0,0,0,0,1,0,1,LW,2025-07-27 14:09:22.504412
705,2,2022,Dinamo Batumi,2,1,1,0,0,0,1,0,1,1,1,0,1,1,0,0.5,1.0,0.0,2,2,0,1.0,2.0,0.0,1,0,1,1,0,1,DL,2025-07-27 14:09:22.504485
194,2,2022,Ajax,6,3,3,2,1,1,0,0,0,4,2,2,11,5,6,1.8,1.7,2.0,16,9,7,2.7,3.0,2.3,1,1,0,1,1,0,WLLLLW,2025-07-27 14:09:22.504561
709,2,2022,Pyunik Yerevan,6,3,3,1,0,1,2,1,1,3,2,1,6,0,6,1.0,0.0,2.0,11,3,8,1.8,1.0,2.7,1,1,0,4,3,1,DDLWLL,2025-07-27 14:09:22.504627
2246,2,2022,CFR 1907 Cluj,2,1,1,0,0,0,2,1,1,0,0,0,2,2,0,1.0,2.0,0.0,2,2,0,1.0,2.0,0.0,1,0,1,1,0,1,DD,2025-07-27 14:09:22.504708
197,2,2022,PSV Eindhoven,4,2,2,1,1,0,2,0,2,1,1,0,6,3,3,1.5,1.5,1.5,6,3,3,1.5,1.5,1.5,0,0,0,1,1,0,DWDL,2025-07-27 14:09:22.504798
2249,2,2022,La Fiorita,1,1,0,0,0,0,0,0,0,1,1,0,1,1,0,1.0,1.0,0.0,2,2,0,2.0,2.0,0.0,0,0,0,0,0,0,L,2025-07-27 14:09:22.504881
2259,2,2022,FK Tobol Kostanay,2,1,1,0,0,0,1,1,0,1,0,1,1,0,1,0.5,0.0,1.0,5,0,5,2.5,0.0,5.0,1,1,0,1,1,0,DL,2025-07-27 14:09:22.504984
211,2,2022,Benfica,14,7,7,10,5,5,3,1,2,1,1,0,38,19,19,2.7,2.7,2.7,15,8,7,1.1,1.1,1.0,4,2,2,1,1,0,WWWWWWDDWWWWLD,2025-07-27 14:09:22.505076
212,2,2022,FC Porto,8,4,4,4,2,2,1,1,0,3,1,2,12,4,8,1.5,1.0,2.0,8,5,3,1.0,1.3,0.8,4,2,2,3,2,1,LLWWWWLD,2025-07-27 14:09:22.505158
2265,2,2022,Shkupi 1927,4,2,2,1,1,0,1,0,1,2,1,1,5,3,2,1.3,1.5,1.0,5,1,4,1.3,0.5,2.0,1,1,0,2,1,1,WLDL,2025-07-27 14:09:22.505235
2273,2,2022,FC Levadia Tallinn,1,1,0,0,0,0,0,0,0,1,1,0,1,1,0,1.0,1.0,0.0,6,6,0,6.0,6.0,0.0,0,0,0,0,0,0,L,2025-07-27 14:09:22.505325
228,2,2022,Sporting CP,6,3,3,2,1,1,1,0,1,3,2,1,8,3,5,1.3,1.0,1.7,9,4,5,1.5,1.3,1.7,2,1,1,1,1,0,WWLLDL,2025-07-27 14:09:22.505409
247,2,2022,Celtic,6,3,3,0,0,0,2,1,1,4,2,2,4,1,3,0.7,0.3,1.0,15,6,9,2.5,2.0,3.0,0,0,0,2,2,0,LDLLDL,2025-07-27 14:09:22.505487
257,2,2022,Rangers,10,5,5,2,1,1,1,1,0,7,3,4,8,7,1,0.8,1.4,0.2,26,15,11,2.6,3.0,2.2,2,1,1,5,1,4,LWDWLLLLLL,2025-07-27 14:09:22.505566
3342,2,2022,Inter Club d'Escaldes,2,1,1,1,0,1,0,0,0,1,1,0,2,0,2,1.0,0.0,2.0,2,1,1,1.0,1.0,1.0,0,0,0,1,1,0,WL,2025-07-27 14:09:22.505647
783,2,2022,FC Zurich,2,1,1,0,0,0,1,1,0,1,0,1,4,2,2,2.0,2.0,2.0,5,2,3,2.5,2.0,3.0,0,0,0,0,0,0,LD,2025-07-27 14:09:22.505717
278,2,2022,Vikingur Reykjavik,4,1,3,2,0,2,1,1,0,1,0,1,12,3,9,3.0,3.0,3.0,7,3,4,1.8,3.0,1.3,1,0,1,0,0,0,WWLD,2025-07-27 14:09:22.505781
3884,2,2022,Hibernians,2,1,1,0,0,0,1,1,0,1,0,1,0,0,0,0.0,0.0,0.0,3,0,3,1.5,0.0,3.0,1,1,0,2,1,1,LD,2025-07-27 14:09:22.505865
327,2,2022,Bodo/Glimt,8,4,4,4,4,0,1,0,1,3,0,3,20,17,3,2.5,4.3,0.8,9,0,9,1.1,0.0,2.3,4,4,0,1,0,1,WLLWWDWL,2025-07-27 14:09:22.505968
347,2,2022,Lech Poznan,2,1,1,1,1,0,0,0,0,1,0,1,2,1,1,1.0,1.0,1.0,5,0,5,2.5,0.0,5.0,1,1,0,0,0,0,WL,2025-07-27 14:09:22.506053
354,2,2022,The New Saints,2,1,1,1,1,0,0,0,0,1,0,1,1,1,0,0.5,1.0,0.0,2,0,2,1.0,0.0,2.0,1,1,0,1,0,1,WL,2025-07-27 14:09:22.506134
1393,2,2022,Union St. Gilloise,2,1,1,1,1,0,0,0,0,1,0,1,2,2,0,1.0,2.0,0.0,3,0,3,1.5,0.0,3.0,1,1,0,1,0,1,WL,2025-07-27 14:09:22.506220
375,2,2022,Malmo FF,4,2,2,1,1,0,1,0,1,2,1,1,6,3,3,1.5,1.5,1.5,8,4,4,2.0,2.0,2.0,0,0,0,2,1,1,WDLL,2025-07-27 14:09:22.506307
392,2,2022,Shakhter Soligorsk,2,1,1,0,0,0,1,0,1,1,1,0,0,0,0,0.0,0.0,0.0,2,2,0,1.0,2.0,0.0,1,0,1,2,1,1,DL,2025-07-27 14:09:22.506390
397,2,2022,FC Midtjylland,4,2,2,0,0,0,2,1,1,2,1,1,4,2,2,1.0,1.0,1.0,9,4,5,2.3,2.0,2.5,0,0,0,0,0,0,DDLL,2025-07-27 14:09:22.506474
400,2,2022,FC Copenhagen,8,4,4,1,1,0,4,3,1,3,0,3,3,3,0,0.4,0.8,0.0,13,2,11,1.6,0.5,2.8,3,2,1,6,2,4,WDLDLDLD,2025-07-27 14:09:22.506537
12733,2,2022,Ballkani,2,1,1,0,0,0,1,1,0,1,0,1,1,1,0,0.5,1.0,0.0,2,1,1,1.0,1.0,1.0,0,0,0,1,0,1,DL,2025-07-27 14:09:22.506598
998,2,2022,Trabzonspor,2,1,1,0,0,0,1,1,0,1,0,1,1,0,1,0.5,0.0,1.0,2,0,2,1.0,0.0,2.0,1,1,0,1,1,0,LD,2025-07-27 14:09:22.506656
489,2,2022,AC Milan,12,6,6,5,4,1,3,0,3,4,2,2,15,9,6,1.3,1.5,1.0,11,5,6,0.9,0.8,1.0,5,3,2,5,2,3,DWLLWWWDWDLL,2025-07-27 14:09:22.506713
492,2,2022,Napoli,10,5,5,7,4,3,1,1,0,2,0,2,26,15,11,2.6,3.0,2.2,8,4,4,0.8,0.8,0.8,4,2,2,2,0,2,WWWWWLWWLD,2025-07-27 14:09:22.506776
496,2,2022,Juventus,6,3,3,1,1,0,0,0,0,5,2,3,9,5,4,1.5,1.7,1.3,13,5,8,2.2,1.7,2.7,0,0,0,1,0,1,LLWLLL,2025-07-27 14:09:22.506840
505,2,2022,Inter,13,6,7,7,4,3,3,1,2,3,1,2,19,10,9,1.5,1.7,1.3,11,5,6,0.8,0.8,0.9,8,4,4,4,1,3,LWWDWLWDWDWWL,2025-07-27 14:09:22.506905
529,2,2023,Barcelona,10,5,5,6,4,2,1,0,1,3,1,2,20,13,7,2.0,2.6,1.4,14,7,7,1.4,1.4,1.4,2,1,1,1,0,1,WWWLWLDWWL,2025-07-27 14:09:22.506968
4626,2,2023,Hamrun Spartans,2,1,1,0,0,0,0,0,0,2,1,1,1,0,1,0.5,0.0,1.0,6,4,2,3.0,4.0,2.0,0,0,0,1,1,0,LL,2025-07-27 14:09:22.507031
530,2,2023,Atletico Madrid,10,5,5,6,5,1,2,0,2,2,0,2,23,15,8,2.3,3.0,1.6,13,4,9,1.3,0.8,1.8,2,2,0,1,0,1,DWDWWWLWWL,2025-07-27 14:09:22.507095
536,2,2023,Sevilla,6,3,3,0,0,0,2,1,1,4,2,2,7,4,3,1.2,1.3,1.0,12,6,6,2.0,2.0,2.0,0,0,0,1,0,1,DDLLLL,2025-07-27 14:09:22.507168
541,2,2023,Real Madrid,13,6,7,9,4,5,4,2,2,0,0,0,28,14,14,2.2,2.3,2.0,15,7,8,1.2,1.2,1.1,4,2,2,0,0,0,WWWWWWWDDDDWW,2025-07-27 14:09:22.507248
33,2,2023,Manchester United,6,3,3,1,1,0,1,0,1,4,2,2,12,3,9,2.0,1.0,3.0,15,4,11,2.5,1.3,3.7,1,1,0,1,1,0,LLWLDL,2025-07-27 14:09:22.507311
34,2,2023,Newcastle,6,3,3,1,1,0,2,0,2,3,2,1,6,5,1,1.0,1.7,0.3,7,4,3,1.2,1.3,1.0,1,0,1,3,1,2,DWLLDL,2025-07-27 14:09:22.507382
2596,2,2023,Farul Constanta,2,1,1,1,1,0,0,0,0,1,0,1,1,1,0,0.5,1.0,0.0,3,0,3,1.5,0.0,3.0,1,1,0,1,0,1,WL,2025-07-27 14:09:22.507476
548,2,2023,Real Sociedad,8,4,4,3,1,2,3,2,1,2,1,1,8,5,3,1.0,1.3,0.8,6,4,2,0.8,1.0,0.5,4,1,3,3,1,2,DWWWDDLL,2025-07-27 14:09:22.507568
550,2,2023,Shakhtar Donetsk,6,3,3,3,2,1,0,0,0,3,1,2,10,3,7,1.7,1.0,2.3,12,3,9,2.0,1.0,3.0,2,2,0,0,0,0,LWLWWL,2025-07-27 14:09:22.507652
3623,2,2023,Dnipro-1,2,1,1,0,0,0,1,0,1,1,1,0,3,1,2,1.5,1.0,2.0,5,3,2,2.5,3.0,2.0,0,0,0,0,0,0,LD,2025-07-27 14:09:22.507738
42,2,2023,Arsenal,10,5,5,5,4,1,2,1,1,3,0,3,19,15,4,1.9,3.0,0.8,8,2,6,0.8,0.4,1.2,4,4,0,2,0,2,WLWWWDLWDL,2025-07-27 14:09:22.507826
556,2,2023,Qarabag,4,2,2,2,1,1,1,1,0,1,0,1,9,5,4,2.3,2.5,2.0,5,1,4,1.3,0.5,2.0,1,1,0,0,0,0,WWLD,2025-07-27 14:09:22.507897
562,2,2023,FC Astana,4,2,2,1,0,1,1,1,0,2,1,1,3,1,2,0.8,0.5,1.0,8,3,5,2.0,1.5,2.5,0,0,0,2,1,1,DWLL,2025-07-27 14:09:22.507979
50,2,2023,Manchester City,10,5,5,8,4,4,2,1,1,0,0,0,28,13,15,2.8,2.6,3.0,13,5,8,1.3,1.0,1.6,1,1,0,0,0,0,WWWWWWWWDD,2025-07-27 14:09:22.508042
565,2,2023,BSC Young Boys,8,4,4,2,2,0,2,0,2,4,2,2,10,7,3,1.3,1.8,0.8,13,6,7,1.6,1.5,1.8,3,2,1,2,0,2,DWLDLLWL,2025-07-27 14:09:22.508114
566,2,2023,Ludogorets,4,2,2,1,1,0,1,1,0,2,0,2,6,5,1,1.5,2.5,0.5,5,1,4,1.3,0.5,2.0,1,1,0,1,0,1,LWDL,2025-07-27 14:09:22.508191
568,2,2023,Sheriff Tiraspol,4,2,2,2,2,0,0,0,0,2,0,2,5,4,1,1.3,2.0,0.5,5,0,5,1.3,0.0,2.5,2,2,0,1,0,1,LWWL,2025-07-27 14:09:22.508274
4153,2,2023,Valmiera / BSS,2,1,1,0,0,0,0,0,0,2,1,1,2,1,1,1.0,1.0,1.0,4,2,2,2.0,2.0,2.0,0,0,0,0,0,0,LL,2025-07-27 14:09:22.508359
571,2,2023,Red Bull Salzburg,6,3,3,1,0,1,1,0,1,4,3,1,4,1,3,0.7,0.3,1.0,8,6,2,1.3,2.0,0.7,2,0,2,3,2,1,WLLLDL,2025-07-27 14:09:22.508443
575,2,2023,AEK Athens FC,4,2,2,1,0,1,1,1,0,2,1,1,5,3,2,1.3,1.5,1.0,6,4,2,1.5,2.0,1.0,0,0,0,1,0,1,WDLL,2025-07-27 14:09:22.508525
579,2,2023,Buducnost Podgorica,2,1,1,1,0,1,0,0,0,1,1,0,3,0,3,1.5,0.0,3.0,5,5,0,2.5,5.0,0.0,1,0,1,1,1,0,WL,2025-07-27 14:09:22.508607
586,2,2023,FK Zalgiris Vilnius,4,2,2,1,0,1,2,2,0,1,0,1,4,2,2,1.0,1.0,1.0,4,2,2,1.0,1.0,1.0,1,1,0,2,1,1,DWDL,2025-07-27 14:09:22.508693
588,2,2023,Zrinjski,4,2,2,1,0,1,1,0,1,2,2,0,5,2,3,1.3,1.0,1.5,6,4,2,1.5,2.0,1.0,1,0,1,1,1,0,WLLD,2025-07-27 14:09:22.508769
81,2,2023,Marseille,2,1,1,1,1,0,0,0,0,1,0,1,2,2,0,1.0,2.0,0.0,2,1,1,1.0,1.0,1.0,0,0,0,1,0,1,LW,2025-07-27 14:09:22.508840
85,2,2023,Paris Saint Germain,12,6,6,5,3,2,2,1,1,5,2,3,19,10,9,1.6,1.7,1.5,15,5,10,1.3,0.8,1.7,3,3,0,2,1,1,WLWLDDWWLWLL,2025-07-27 14:09:22.508910
2646,2,2023,TSC Backa Topola,2,1,1,0,0,0,0,0,0,2,1,1,1,1,0,0.5,1.0,0.0,7,4,3,3.5,4.0,3.0,0,0,0,1,0,1,LL,2025-07-27 14:09:22.508996
598,2,2023,FK Crvena Zvezda,6,3,3,0,0,0,1,1,0,5,2,3,7,5,2,1.2,1.7,0.7,15,7,8,2.5,2.3,2.7,0,0,0,1,0,1,LDLLLL,2025-07-27 14:09:22.509083
4195,2,2023,Maccabi Haifa,8,4,4,5,3,2,1,1,0,2,0,2,15,9,6,1.9,2.3,1.5,8,3,5,1.0,0.8,1.3,2,1,1,3,1,2,WWLWWWDL,2025-07-27 14:09:22.509172
617,2,2023,Panathinaikos,6,3,3,2,1,1,1,1,0,3,1,2,8,3,5,1.3,1.0,1.7,8,3,5,1.3,1.0,1.7,1,1,0,1,1,0,WDWLLL,2025-07-27 14:09:22.509259
620,2,2023,Dinamo Zagreb,4,2,2,2,1,1,1,0,1,1,1,0,9,5,4,2.3,2.5,2.0,4,2,2,1.0,1.0,1.0,2,1,1,0,0,0,WWLD,2025-07-27 14:09:22.509338
628,2,2023,Sparta Praha,2,1,1,0,0,0,2,1,1,0,0,0,3,3,0,1.5,3.0,0.0,3,3,0,1.5,3.0,0.0,1,0,1,1,0,1,DD,2025-07-27 14:09:22.509396
116,2,2023,Lens,6,3,3,2,2,0,2,1,1,2,0,2,6,5,1,1.0,1.7,0.3,11,3,8,1.8,1.0,2.7,0,0,0,2,0,2,DWDLLW,2025-07-27 14:09:22.509462
637,2,2023,Sturm Graz,2,1,1,0,0,0,0,0,0,2,1,1,2,1,1,1.0,1.0,1.0,7,3,4,3.5,3.0,4.0,0,0,0,0,0,0,LL,2025-07-27 14:09:22.509534
11907,2,2023,Swift Hesperange,2,1,1,0,0,0,1,0,1,1,1,0,1,0,1,0.5,0.0,1.0,3,2,1,1.5,2.0,1.0,0,0,0,1,1,0,DL,2025-07-27 14:09:22.509596
645,2,2023,Galatasaray,12,6,6,6,3,3,3,2,1,3,1,2,22,10,12,1.8,1.7,2.0,18,9,9,1.5,1.5,1.5,3,2,1,1,0,1,DWWWWWDWLLDL,2025-07-27 14:09:22.509673
2184,2,2023,Servette FC,4,2,2,0,0,0,3,2,1,1,0,1,5,2,3,1.3,1.0,1.5,6,2,4,1.5,1.0,2.0,0,0,0,0,0,0,DDLD,2025-07-27 14:09:22.509741
649,2,2023,HJK helsinki,4,2,2,2,2,0,1,0,1,1,0,1,4,2,2,1.0,1.0,1.0,4,0,4,1.0,0.0,2.0,2,2,0,1,0,1,WDWL,2025-07-27 14:09:22.509815
651,2,2023,Ferencvarosi TC,2,1,1,0,0,0,1,0,1,1,1,0,0,0,0,0.0,0.0,0.0,3,3,0,1.5,3.0,0.0,1,0,1,2,1,1,DL,2025-07-27 14:09:22.509899
652,2,2023,Shamrock Rovers,2,1,1,0,0,0,0,0,0,2,1,1,1,0,1,0.5,0.0,1.0,3,1,2,1.5,1.0,2.0,0,0,0,1,1,0,LL,2025-07-27 14:09:22.509965
656,2,2023,Slovan Bratislava,6,3,3,2,0,2,2,2,0,2,1,1,8,4,4,1.3,1.3,1.3,8,5,3,1.3,1.7,1.0,2,0,2,0,0,0,DWWDLL,2025-07-27 14:09:22.510024
667,2,2023,Lincoln Red Imps FC,2,1,1,0,0,0,0,0,0,2,1,1,1,1,0,0.5,1.0,0.0,6,2,4,3.0,2.0,4.0,0,0,0,1,0,1,LL,2025-07-27 14:09:22.510112
157,2,2023,Bayern München,12,6,6,7,4,3,3,2,1,2,0,2,21,12,9,1.8,2.0,1.5,13,6,7,1.1,1.0,1.2,4,3,1,2,1,1,WWWWDWLWDWDL,2025-07-27 14:09:22.510178
677,2,2023,Olimpija Ljubljana,6,3,3,3,2,1,1,0,1,2,1,1,7,4,3,1.2,1.3,1.0,8,5,3,1.3,1.7,1.0,0,0,0,2,1,1,WWDWLL,2025-07-27 14:09:22.510240
165,2,2023,Borussia Dortmund,13,7,6,7,4,3,3,2,1,3,1,2,17,10,7,1.3,1.4,1.2,11,5,6,0.8,0.7,1.0,6,4,2,3,2,1,LDWWWDDWLWWWL,2025-07-27 14:09:22.510331
173,2,2023,RB Leipzig,8,4,4,4,2,2,1,0,1,3,2,1,14,6,8,1.8,1.5,2.0,12,6,6,1.5,1.5,1.5,0,0,0,1,1,0,WLWWLWLD,2025-07-27 14:09:22.510411
687,2,2023,Flora Tallinn,2,1,1,0,0,0,0,0,0,2,1,1,0,0,0,0.0,0.0,0.0,4,3,1,2.0,3.0,1.0,0,0,0,2,1,1,LL,2025-07-27 14:09:22.510495
182,2,2023,Union Berlin,6,3,3,0,0,0,2,0,2,4,3,1,6,4,2,1.0,1.3,0.7,10,7,3,1.7,2.3,1.0,0,0,0,2,1,1,LLLDDL,2025-07-27 14:09:22.510572
700,2,2023,Tre Penne,1,1,0,0,0,0,0,0,0,1,1,0,1,1,0,1.0,1.0,0.0,7,7,0,7.0,7.0,0.0,0,0,0,0,0,0,L,2025-07-27 14:09:22.510657
701,2,2023,KI Klaksvik,6,3,3,2,1,1,3,2,1,1,0,1,8,2,6,1.3,0.7,2.0,6,1,5,1.0,0.3,1.7,3,2,1,3,2,1,DWDDWL,2025-07-27 14:09:22.510745
708,2,2023,Partizani,2,1,1,0,0,0,1,1,0,1,0,1,1,1,0,0.5,1.0,0.0,3,1,2,1.5,1.0,2.0,0,0,0,1,0,1,DL,2025-07-27 14:09:22.510830
197,2,2023,PSV Eindhoven,12,6,6,5,3,2,5,3,2,2,0,2,23,14,9,1.9,2.3,1.5,18,6,12,1.5,1.0,2.0,1,1,0,2,0,2,WWDWLDDWWDDL,2025-07-27 14:09:22.510953
209,2,2023,Feyenoord,6,3,3,2,2,0,0,0,0,4,1,3,9,6,3,1.5,2.0,1.0,10,4,6,1.7,1.3,2.0,1,1,0,1,0,1,WLWLLL,2025-07-27 14:09:22.511044
211,2,2023,Benfica,6,3,3,1,0,1,1,1,0,4,2,2,7,3,4,1.2,1.0,1.3,11,6,5,1.8,2.0,1.7,0,0,0,3,2,1,LLLLDW,2025-07-27 14:09:22.511135
212,2,2023,FC Porto,8,4,4,5,3,2,0,0,0,3,1,2,16,8,8,2.0,2.0,2.0,9,4,5,1.1,1.0,1.3,2,2,0,2,1,1,WLWWLWWL,2025-07-27 14:09:22.511221
2262,2,2023,Dinamo Tbilisi,2,1,1,0,0,0,1,0,1,1,1,0,2,1,1,1.0,1.0,1.0,3,2,1,1.5,2.0,1.0,0,0,0,0,0,0,DL,2025-07-27 14:09:22.511306
217,2,2023,SC Braga,10,5,5,5,2,3,1,1,0,4,2,2,16,8,8,1.6,1.6,1.6,14,6,8,1.4,1.2,1.6,2,1,1,2,0,2,WWWWLWLLDL,2025-07-27 14:09:22.511390
2276,2,2023,FC Urartu,2,1,1,1,0,1,0,0,0,1,1,0,3,0,3,1.5,0.0,3.0,3,1,2,1.5,1.0,2.0,0,0,0,1,1,0,LW,2025-07-27 14:09:22.511472
740,2,2023,Antwerp,8,4,4,3,2,1,0,0,0,5,2,3,9,7,2,1.1,1.8,0.5,18,9,9,2.3,2.3,2.3,1,1,0,3,0,3,WWLLLLLW,2025-07-27 14:09:22.511551
742,2,2023,Genk,2,1,1,0,0,0,2,1,1,0,0,0,3,2,1,1.5,2.0,1.0,3,2,1,1.5,2.0,1.0,0,0,0,0,0,0,DD,2025-07-27 14:09:22.511639
5354,2,2023,Larne,2,1,1,0,0,0,1,1,0,1,0,1,2,2,0,1.0,2.0,0.0,3,2,1,1.5,2.0,1.0,0,0,0,1,0,1,LD,2025-07-27 14:09:22.511725
247,2,2023,Celtic,6,3,3,1,1,0,1,1,0,4,1,3,5,5,0,0.8,1.7,0.0,15,5,10,2.5,1.7,3.3,0,0,0,3,0,3,LLDLLW,2025-07-27 14:09:22.511813
4346,2,2023,Struga,2,1,1,0,0,0,1,0,1,1,1,0,1,1,0,0.5,1.0,0.0,2,2,0,1.0,2.0,0.0,1,0,1,1,0,1,DL,2025-07-27 14:09:22.511885
257,2,2023,Rangers,4,2,2,1,1,0,2,1,1,1,0,1,6,4,2,1.5,2.0,1.0,9,3,6,2.3,1.5,3.0,0,0,0,0,0,0,WDDL,2025-07-27 14:09:22.511949
3345,2,2023,Atlètic Club d'Escaldes,1,1,0,0,0,0,0,0,0,1,1,0,0,0,0,0.0,0.0,0.0,3,3,0,3.0,3.0,0.0,0,0,0,1,1,0,L,2025-07-27 14:09:22.512024
276,2,2023,Breidablik,6,2,4,4,1,3,0,0,0,2,1,1,18,2,16,3.0,1.0,4.0,10,3,7,1.7,1.5,1.8,2,0,2,1,1,0,WWWWLL,2025-07-27 14:09:22.512081
329,2,2023,Molde,6,3,3,2,2,0,0,0,0,4,1,3,8,6,2,1.3,2.0,0.7,8,3,5,1.3,1.0,1.7,2,2,0,1,0,1,LWLWLL,2025-07-27 14:09:22.512153
3408,2,2023,Aris,4,2,2,2,1,1,0,0,0,2,1,1,12,6,6,3.0,3.0,3.0,8,3,5,2.0,1.5,2.5,0,0,0,1,1,0,WWLL,2025-07-27 14:09:22.512227
354,2,2023,The New Saints,2,1,1,0,0,0,0,0,0,2,1,1,1,0,1,0.5,0.0,1.0,5,2,3,2.5,2.0,3.0,0,0,0,1,1,0,LL,2025-07-27 14:09:22.512303
367,2,2023,BK Hacken,4,2,2,2,1,1,2,1,1,0,0,0,8,6,2,2.0,3.0,1.0,4,4,0,1.0,2.0,0.0,2,0,2,1,0,1,WWDD,2025-07-27 14:09:22.512373
388,2,2023,Bate Borisov,4,2,2,1,1,0,1,0,1,2,1,1,8,5,3,2.0,2.5,1.5,12,5,7,3.0,2.5,3.5,1,1,0,0,0,0,DWLL,2025-07-27 14:09:22.512440
400,2,2023,FC Copenhagen,14,7,7,5,3,2,5,2,3,4,2,2,23,14,9,1.6,2.0,1.3,21,12,9,1.5,1.7,1.3,5,2,3,3,1,2,WWDDWDDLLWDWLL,2025-07-27 14:09:22.512501
3491,2,2023,Raków Częstochowa,8,4,4,5,3,2,2,0,2,1,1,0,12,6,6,1.5,1.5,1.5,6,4,2,0.8,1.0,0.5,3,1,2,1,1,0,WWWDWWLD,2025-07-27 14:09:22.512569
12733,2,2023,Ballkani,2,1,1,1,1,0,0,0,0,1,0,1,2,2,0,1.0,2.0,0.0,4,0,4,2.0,0.0,4.0,1,1,0,1,0,1,WL,2025-07-27 14:09:22.512631
487,2,2023,Lazio,8,4,4,4,3,1,1,1,0,3,0,3,8,5,3,1.0,1.3,0.8,10,1,9,1.3,0.3,2.3,3,3,0,2,0,2,DWLWWLWL,2025-07-27 14:09:22.512698
489,2,2023,AC Milan,6,3,3,2,1,1,2,1,1,2,1,1,5,3,2,0.8,1.0,0.7,8,4,4,1.3,1.3,1.3,2,1,1,3,1,2,DDLWLW,2025-07-27 14:09:22.512764
492,2,2023,Napoli,8,4,4,3,1,2,2,2,0,3,1,2,12,6,6,1.5,1.5,1.5,13,5,8,1.6,1.3,2.0,2,1,1,0,0,0,WLWDLWDL,2025-07-27 14:09:22.512829
505,2,2023,Inter,8,4,4,4,3,1,3,1,2,1,0,1,10,4,6,1.3,1.0,1.5,7,1,6,0.9,0.3,1.5,4,3,1,1,1,0,DWWWDDWL,2025-07-27 14:09:22.512896
529,2,2024,Barcelona,14,7,7,9,5,4,2,2,0,3,0,3,43,24,19,3.1,3.4,2.7,24,7,17,1.7,1.0,2.4,4,3,1,0,0,0,LWWWWWWDWWWLDL,2025-07-27 14:09:22.512952
4626,2,2024,Hamrun Spartans,2,1,1,1,0,1,0,0,0,1,1,0,1,0,1,0.5,0.0,1.0,1,1,0,0.5,1.0,0.0,1,0,1,1,1,0,LW,2025-07-27 14:09:22.513035
530,2,2024,Atletico Madrid,10,5,5,7,4,3,0,0,0,3,1,2,22,9,13,2.2,1.8,2.6,14,6,8,1.4,1.2,1.6,2,1,1,1,0,1,WLLWWWWWLW,2025-07-27 14:09:22.513091
541,2,2024,Real Madrid,14,7,7,8,5,3,0,0,0,6,2,4,29,20,9,2.1,2.9,1.3,22,11,11,1.6,1.6,1.6,1,0,1,4,0,4,WLWLLWWWWWWLLL,2025-07-27 14:09:22.513156
547,2,2024,Girona,8,4,4,1,1,0,0,0,0,7,3,4,5,5,0,0.6,1.3,0.0,13,6,7,1.6,1.5,1.8,1,1,0,5,1,4,LLWLLLLL,2025-07-27 14:09:22.513224
550,2,2024,Shakhtar Donetsk,8,4,4,2,2,0,1,0,1,5,2,3,8,5,3,1.0,1.3,0.8,16,9,7,2.0,2.3,1.8,2,1,1,3,1,2,DLLWLLWL,2025-07-27 14:09:22.513296
40,2,2024,Liverpool,10,5,5,8,4,4,0,0,0,2,1,1,18,10,8,1.8,2.0,1.6,6,2,4,0.6,0.4,0.8,6,3,3,1,1,0,WWWWWWWLWL,2025-07-27 14:09:22.513382
42,2,2024,Arsenal,14,7,7,9,5,4,2,1,1,3,1,2,31,14,17,2.2,2.0,2.4,10,3,7,0.7,0.4,1.0,6,5,1,3,1,2,DWWLWWWWWDWWLL,2025-07-27 14:09:22.513463
556,2,2024,Qarabag,6,3,3,3,1,2,0,0,0,3,2,1,15,6,9,2.5,2.0,3.0,9,4,5,1.5,1.3,1.7,2,1,1,2,1,1,WWLWLL,2025-07-27 14:09:22.513542
559,2,2024,FCSB,6,3,3,3,1,2,2,1,1,1,1,0,16,7,9,2.7,2.3,3.0,6,4,2,1.0,1.3,0.7,2,1,1,0,0,0,WWDWDL,2025-07-27 14:09:22.513618
560,2,2024,Slavia Praha,4,2,2,3,2,1,0,0,0,1,0,1,6,5,1,1.5,2.5,0.5,4,2,2,1.0,1.0,1.0,1,0,1,1,0,1,WWLW,2025-07-27 14:09:22.513706
50,2,2024,Manchester City,10,5,5,3,2,1,2,2,0,5,1,4,21,13,8,2.1,2.6,1.6,20,7,13,2.0,1.4,2.6,3,2,1,2,1,1,DWWLDLLWLL,2025-07-27 14:09:22.513784
565,2,2024,BSC Young Boys,10,5,5,2,1,1,0,0,0,8,4,4,7,4,3,0.7,0.8,0.6,26,13,13,2.6,2.6,2.6,1,0,1,5,3,2,WWLLLLLLLL,2025-07-27 14:09:22.513864
566,2,2024,Ludogorets,6,3,3,3,2,1,0,0,0,3,1,2,9,7,2,1.5,2.3,0.7,11,8,3,1.8,2.7,1.0,1,1,0,2,0,2,WLWLWL,2025-07-27 14:09:22.513963
569,2,2024,Club Brugge KV,12,6,6,5,3,2,2,1,1,5,2,3,13,6,7,1.1,1.0,1.2,19,8,11,1.6,1.3,1.8,3,2,1,3,2,1,LWLWDWDLWWLL,2025-07-27 14:09:22.514051
571,2,2024,Red Bull Salzburg,12,6,6,3,1,2,2,1,1,7,4,3,13,4,9,1.1,0.7,1.5,32,15,17,2.7,2.5,2.8,1,0,1,5,3,2,WDWDLLLWLLLL,2025-07-27 14:09:22.514132
572,2,2024,Dynamo Kyiv,6,3,3,3,1,2,2,1,1,1,1,0,13,7,6,2.2,2.3,2.0,6,5,1,1.0,1.7,0.3,2,0,2,1,1,0,WWDWLD,2025-07-27 14:09:22.514204
573,2,2024,FK Partizan,2,1,1,0,0,0,0,0,0,2,1,1,2,0,2,1.0,0.0,2.0,9,3,6,4.5,3.0,6.0,0,0,0,1,1,0,LL,2025-07-27 14:09:22.514295
4160,2,2024,Rīgas FS,4,2,2,2,1,1,0,0,0,2,1,1,8,4,4,2.0,2.0,2.0,7,3,4,1.8,1.5,2.0,2,1,1,1,0,1,WWLL,2025-07-27 14:09:22.514382
66,2,2024,Aston Villa,12,6,6,8,5,3,1,1,0,3,0,3,23,13,10,1.9,2.2,1.7,12,4,8,1.0,0.7,1.3,5,4,1,3,1,2,WWWLDWLWWWLW,2025-07-27 14:09:22.514469
79,2,2024,Lille,14,7,7,7,5,2,3,1,2,4,1,3,25,16,9,1.8,2.3,1.3,17,7,10,1.2,1.0,1.4,2,2,0,1,0,1,WDWLLWWDWWLWDL,2025-07-27 14:09:22.514552
85,2,2024,Paris Saint Germain,17,9,8,11,6,5,1,1,0,5,2,3,38,24,14,2.2,2.7,1.8,15,8,7,0.9,0.9,0.9,7,3,4,3,1,2,WLDLLWWWWWLWWLWWW,2025-07-27 14:09:22.514640
598,2,2024,FK Crvena Zvezda,10,5,5,3,2,1,0,0,0,7,3,4,16,12,4,1.6,2.4,0.8,24,11,13,2.4,2.2,2.6,2,1,1,1,0,1,LWLLLLWLLW,2025-07-27 14:09:22.514699
91,2,2024,Monaco,10,5,5,4,3,1,2,0,2,4,2,2,16,10,6,1.6,2.0,1.2,17,6,11,1.7,1.2,2.2,2,1,1,3,1,2,WDWWLLWLLD,2025-07-27 14:09:22.514768
604,2,2024,Maccabi Tel Aviv,2,1,1,0,0,0,1,0,1,1,1,0,1,0,1,0.5,0.0,1.0,2,1,1,1.0,1.0,1.0,0,0,0,1,1,0,DL,2025-07-27 14:09:22.514858
606,2,2024,FC Lugano,2,1,1,0,0,0,0,0,0,2,1,1,4,3,1,2.0,3.0,1.0,6,4,2,3.0,4.0,2.0,0,0,0,0,0,0,LL,2025-07-27 14:09:22.514936
611,2,2024,Fenerbahce,4,2,2,2,1,1,1,1,0,1,0,1,8,3,5,2.0,1.5,2.5,7,2,5,1.8,1.0,2.5,0,0,0,0,0,0,WWLD,2025-07-27 14:09:22.515021
106,2,2024,Stade Brestois 29,10,5,5,4,2,2,1,1,0,5,2,3,10,4,6,1.0,0.8,1.2,21,8,13,2.1,1.6,2.6,2,1,1,5,2,3,WWDWLWLLLL,2025-07-27 14:09:22.515111
619,2,2024,PAOK,4,2,2,2,1,1,1,0,1,1,1,0,9,6,3,2.3,3.0,1.5,8,6,2,2.0,3.0,1.0,1,0,1,0,0,0,WWDL,2025-07-27 14:09:22.515207
620,2,2024,Dinamo Zagreb,10,5,5,5,2,3,2,2,0,3,1,2,17,7,10,1.7,1.4,2.0,19,6,13,1.9,1.2,2.6,4,2,2,3,2,1,WWLDWWLDLW,2025-07-27 14:09:22.515288
628,2,2024,Sparta Praha,14,7,7,6,3,3,2,1,1,6,3,3,21,11,10,1.5,1.6,1.4,26,12,14,1.9,1.7,2.0,4,2,2,4,2,2,WWDWWWWDLLLLLL,2025-07-27 14:09:22.515378
637,2,2024,Sturm Graz,8,4,4,2,2,0,0,0,0,6,2,4,5,2,3,0.6,0.5,0.8,14,3,11,1.8,0.8,2.8,2,2,0,4,2,2,LLLLWLLW,2025-07-27 14:09:22.515461
645,2,2024,Galatasaray,2,1,1,0,0,0,0,0,0,2,1,1,2,0,2,1.0,0.0,2.0,4,1,3,2.0,1.0,3.0,0,0,0,1,1,0,LL,2025-07-27 14:09:22.515546
649,2,2024,HJK helsinki,2,1,1,0,0,0,1,1,0,1,0,1,1,1,0,0.5,1.0,0.0,4,1,3,2.0,1.0,3.0,0,0,0,1,0,1,LD,2025-07-27 14:09:22.515629
651,2,2024,Ferencvarosi TC,4,2,2,2,1,1,1,1,0,1,0,1,8,6,2,2.0,3.0,1.0,4,1,3,1.0,0.5,1.5,1,1,0,1,0,1,WWLD,2025-07-27 14:09:22.515711
652,2,2024,Shamrock Rovers,4,2,2,1,1,0,1,0,1,2,1,1,4,2,2,1.0,1.0,1.0,7,3,4,1.8,1.5,2.0,1,0,1,2,1,1,DWLL,2025-07-27 14:09:22.515798
656,2,2024,Slovan Bratislava,16,8,8,5,4,1,3,0,3,8,4,4,25,18,7,1.6,2.3,0.9,34,18,16,2.1,2.3,2.0,3,2,1,3,1,2,WWDWWDDWLLLLLLLL,2025-07-27 14:09:22.515881
667,2,2024,Lincoln Red Imps FC,4,2,2,1,0,1,0,0,0,3,2,1,1,0,1,0.3,0.0,0.5,8,3,5,2.0,1.5,2.5,1,0,1,3,2,1,WLLL,2025-07-27 14:09:22.515964
157,2,2024,Bayern München,14,7,7,8,5,3,2,1,1,4,1,3,31,19,12,2.2,2.7,1.7,18,6,12,1.3,0.9,1.7,4,3,1,2,0,2,WLLWWWLWWDWWLD,2025-07-27 14:09:22.516040
3745,2,2024,Dečić,2,1,1,0,0,0,1,1,0,1,0,1,1,1,0,0.5,1.0,0.0,4,1,3,2.0,1.0,3.0,0,0,0,1,0,1,LD,2025-07-27 14:09:22.516107
165,2,2024,Borussia Dortmund,14,7,7,8,4,4,2,2,0,4,1,3,31,17,14,2.2,2.4,2.0,19,7,12,1.4,1.0,1.7,5,2,3,2,1,1,WWLWWLLWWDDWLW,2025-07-27 14:09:22.516177
168,2,2024,Bayer Leverkusen,10,5,5,5,4,1,1,0,1,4,1,3,15,9,6,1.5,1.8,1.2,12,2,10,1.2,0.4,2.0,5,4,1,3,1,2,WWDLWWLWLL,2025-07-27 14:09:22.516238
684,2,2024,FC Differdange 03,2,1,1,0,0,0,1,1,0,1,0,1,0,0,0,0.0,0.0,0.0,2,0,2,1.0,0.0,2.0,1,1,0,2,1,1,LD,2025-07-27 14:09:22.516298
172,2,2024,VfB Stuttgart,8,4,4,3,1,2,1,1,0,4,2,2,13,7,6,1.6,1.8,1.5,17,8,9,2.1,2.0,2.3,1,0,1,1,1,0,LDWLLWWL,2025-07-27 14:09:22.516361
173,2,2024,RB Leipzig,8,4,4,1,1,0,0,0,0,7,3,4,8,6,2,1.0,1.5,0.5,15,8,7,1.9,2.0,1.8,0,0,0,3,1,2,LLLLLLWL,2025-07-27 14:09:22.516435
687,2,2024,Flora Tallinn,2,1,1,0,0,0,0,0,0,2,1,1,1,0,1,0.5,0.0,1.0,7,5,2,3.5,5.0,2.0,0,0,0,1,1,0,LL,2025-07-27 14:09:22.516500
692,2,2024,Ordabasy,2,1,1,0,0,0,1,1,0,1,0,1,0,0,0,0.0,0.0,0.0,1,0,1,0.5,0.0,1.0,1,1,0,2,1,1,DL,2025-07-27 14:09:22.516573
5308,2,2024,Virtus,2,1,1,0,0,0,0,0,0,2,1,1,1,1,0,0.5,1.0,0.0,11,7,4,5.5,7.0,4.0,0,0,0,1,0,1,LL,2025-07-27 14:09:22.516656
701,2,2024,KI Klaksvik,4,2,2,2,2,0,1,0,1,1,0,1,6,5,1,1.5,2.5,0.5,6,2,4,1.5,1.0,2.0,2,1,1,1,0,1,WDLW,2025-07-27 14:09:22.516713
703,2,2024,UE Santa Coloma,4,2,2,1,0,1,0,0,0,3,2,1,3,1,2,0.8,0.5,1.0,7,5,2,1.8,2.5,1.0,0,0,0,2,1,1,LWLL,2025-07-27 14:09:22.516780
705,2,2024,Dinamo Batumi,2,1,1,1,1,0,0,0,0,1,0,1,2,1,1,1.0,1.0,1.0,3,0,3,1.5,0.0,3.0,1,1,0,0,0,0,LW,2025-07-27 14:09:22.516868
709,2,2024,Pyunik Yerevan,2,1,1,0,0,0,1,0,1,1,1,0,0,0,0,0.0,0.0,0.0,1,1,0,0.5,1.0,0.0,1,0,1,2,1,1,DL,2025-07-27 14:09:22.516959
197,2,2024,PSV Eindhoven,12,6,6,5,4,1,3,1,2,4,1,3,23,15,8,1.9,2.5,1.3,24,13,11,2.0,2.2,1.8,1,1,0,1,0,1,LDDWWLWWLWLD,2025-07-27 14:09:22.517046
2247,2,2024,Apoel Nicosia,4,2,2,1,1,0,2,1,1,1,0,1,2,1,1,0.5,0.5,0.5,3,0,3,0.8,0.0,1.5,2,2,0,2,1,1,WDLD,2025-07-27 14:09:22.517136
209,2,2024,Feyenoord,12,6,6,5,3,2,2,0,2,5,3,2,21,9,12,1.8,1.5,2.0,26,11,15,2.2,1.8,2.5,2,2,0,2,2,0,LWWLDWWLWDLL,2025-07-27 14:09:22.517219
211,2,2024,Benfica,12,6,6,5,1,4,2,2,0,5,3,2,21,12,9,1.8,2.0,1.5,19,12,7,1.6,2.0,1.2,4,2,2,3,2,1,WWLLWDLWWDLL,2025-07-27 14:09:22.517303
2271,2,2024,Petrocub,4,2,2,1,1,0,2,1,1,1,0,1,2,2,0,0.5,1.0,0.0,2,1,1,0.5,0.5,0.5,2,1,1,2,0,2,DWLD,2025-07-27 14:09:22.517390
228,2,2024,Sporting CP,10,5,5,3,2,1,3,1,2,4,2,2,13,8,5,1.3,1.6,1.0,15,10,5,1.5,2.0,1.0,3,1,2,2,1,1,WDWWLLLDLD,2025-07-27 14:09:22.517470
5354,2,2024,Larne,2,1,1,0,0,0,0,0,0,2,1,1,0,0,0,0.0,0.0,0.0,7,4,3,3.5,4.0,3.0,0,0,0,2,1,1,LL,2025-07-27 14:09:22.517551
247,2,2024,Celtic,10,5,5,3,3,0,4,1,3,3,1,2,15,11,4,1.5,2.2,0.8,17,5,12,1.7,1.0,2.4,3,1,2,2,0,2,WLDWDDWLLD,2025-07-27 14:09:22.517633
4346,2,2024,Struga,2,1,1,0,0,0,0,0,0,2,1,1,3,1,2,1.5,1.0,2.0,6,2,4,3.0,2.0,4.0,0,0,0,0,0,0,LL,2025-07-27 14:09:22.517714
3327,2,2024,Egnatia Rrogozhinë,2,1,1,1,1,0,0,0,0,1,0,1,2,2,0,1.0,2.0,0.0,2,1,1,1.0,1.0,1.0,0,0,0,1,0,1,LW,2025-07-27 14:09:22.517796
257,2,2024,Rangers,2,1,1,0,0,0,1,0,1,1,1,0,1,0,1,0.5,0.0,1.0,3,2,1,1.5,2.0,1.0,0,0,0,1,1,0,DL,2025-07-27 14:09:22.517876
4360,2,2024,Celje,4,2,2,2,1,1,1,1,0,1,0,1,8,3,5,2.0,1.5,2.5,7,2,5,1.8,1.0,2.5,1,0,1,1,0,1,WWDL,2025-07-27 14:09:22.517955
278,2,2024,Vikingur Reykjavik,2,1,1,0,0,0,1,1,0,1,0,1,1,0,1,0.5,0.0,1.0,2,0,2,1.0,0.0,2.0,1,1,0,1,1,0,DL,2025-07-27 14:09:22.518038
3874,2,2024,Panevėžys,4,2,2,1,1,0,1,0,1,2,1,1,5,3,2,1.3,1.5,1.0,8,4,4,2.0,2.0,2.0,1,1,0,1,1,0,WDLL,2025-07-27 14:09:22.518118
3364,2,2024,Borac Banja Luka,4,2,2,1,1,0,0,0,0,3,1,2,4,1,3,1.0,0.5,1.5,6,1,5,1.5,0.5,2.5,1,1,0,1,1,0,WLLL,2025-07-27 14:09:22.518198
327,2,2024,Bodo/Glimt,6,3,3,5,3,2,0,0,0,1,0,1,14,10,4,2.3,3.3,1.3,5,2,3,0.8,0.7,1.0,2,1,1,1,0,1,WWWWWL,2025-07-27 14:09:22.518284
336,2,2024,Jagiellonia,4,2,2,2,1,1,0,0,0,2,1,1,8,3,5,2.0,1.5,2.5,6,2,4,1.5,1.0,2.0,1,0,1,1,1,0,WWLL,2025-07-27 14:09:22.518365
354,2,2024,The New Saints,4,2,2,1,1,0,1,0,1,2,1,1,5,4,1,1.3,2.0,0.5,8,2,6,2.0,1.0,3.0,1,1,0,1,0,1,WDLL,2025-07-27 14:09:22.518448
1393,2,2024,Union St. Gilloise,2,1,1,0,0,0,0,0,0,2,1,1,1,0,1,0.5,0.0,1.0,4,1,3,2.0,1.0,3.0,0,0,0,1,1,0,LL,2025-07-27 14:09:22.518535
375,2,2024,Malmo FF,6,3,3,2,1,1,1,1,0,3,1,2,12,6,6,2.0,2.0,2.0,13,5,8,2.2,1.7,2.7,0,0,0,2,1,1,WLDWLL,2025-07-27 14:09:22.518628
394,2,2024,Dinamo Minsk,4,2,2,2,1,1,1,1,0,1,0,1,2,1,1,0.5,0.5,0.5,2,0,2,0.5,0.0,1.0,3,2,1,2,1,1,DWLW,2025-07-27 14:09:22.518710
397,2,2024,FC Midtjylland,6,3,3,3,2,1,2,1,1,1,0,1,10,4,6,1.7,1.3,2.0,5,1,4,0.8,0.3,1.3,3,2,1,0,0,0,WWWDDL,2025-07-27 14:09:22.518785
415,2,2024,Twente,2,1,1,0,0,0,1,1,0,1,0,1,4,3,1,2.0,3.0,1.0,5,3,2,2.5,3.0,2.0,0,0,0,0,0,0,LD,2025-07-27 14:09:22.518858
12733,2,2024,Ballkani,2,1,1,1,0,1,0,0,0,1,1,0,3,1,2,1.5,1.0,2.0,3,2,1,1.5,2.0,1.0,0,0,0,0,0,0,WL,2025-07-27 14:09:22.518958
489,2,2024,AC Milan,10,5,5,5,3,2,1,1,0,4,1,3,15,8,7,1.5,1.6,1.4,13,6,7,1.3,1.2,1.4,1,1,0,2,0,2,LLWWWWWLLD,2025-07-27 14:09:22.519056
496,2,2024,Juventus,10,5,5,4,3,1,3,0,3,3,2,1,12,7,5,1.2,1.4,1.0,11,5,6,1.1,1.0,1.2,3,1,2,4,2,2,WWLDDWDLWL,2025-07-27 14:09:22.519171
499,2,2024,Atalanta,10,5,5,4,1,3,3,2,1,3,2,1,22,8,14,2.2,1.6,2.8,11,6,5,1.1,1.2,1.0,5,3,2,2,2,0,DWDWWLWDLL,2025-07-27 14:09:22.519269
500,2,2024,Bologna,8,4,4,1,1,0,3,1,2,4,2,2,4,3,1,0.5,0.8,0.3,9,4,5,1.1,1.0,1.3,2,1,1,5,2,3,DLLLLDWD,2025-07-27 14:09:22.519371
505,2,2024,Inter,15,7,8,10,6,4,3,1,2,2,0,2,26,17,9,1.7,2.4,1.1,16,6,10,1.1,0.9,1.3,8,4,4,3,0,3,DWWWWLWWWWWDDWL,2025-07-27 14:09:22.519459
1025,3,2020,Wolfsberger AC,8,4,4,3,1,2,1,1,0,4,2,2,8,3,5,1.0,0.8,1.3,14,8,6,1.8,2.0,1.5,2,1,1,3,1,2,DWLLWWLL,2025-07-27 14:09:22.519548
1026,3,2020,Lask Linz,8,4,4,5,2,3,1,1,0,2,1,1,22,14,8,2.8,3.5,2.0,13,8,5,1.6,2.0,1.3,2,1,1,2,1,1,WWLWWLDW,2025-07-27 14:09:22.519641
4619,3,2020,Sirens,1,0,1,0,0,0,0,0,0,1,0,1,1,0,1,1.0,0.0,1.0,2,0,2,2.0,0.0,2.0,0,0,0,0,0,0,L,2025-07-27 14:09:22.519734
4625,3,2020,Floriana,2,1,1,1,0,1,1,1,0,0,0,0,1,0,1,0.5,0.0,1.0,0,0,0,0.0,0.0,0.0,2,1,1,1,1,0,WD,2025-07-27 14:09:22.519827
2581,3,2020,FC Botosani,2,1,1,1,0,1,0,0,0,1,1,0,2,0,2,1.0,0.0,2.0,2,1,1,1.0,1.0,1.0,0,0,0,1,1,0,WL,2025-07-27 14:09:22.519917
533,3,2020,Villarreal,15,8,7,12,7,5,3,1,2,0,0,0,31,21,10,2.1,2.6,1.4,9,7,2,0.6,0.9,0.3,8,3,5,1,0,1,WWWDWWWWWWWWWDD,2025-07-27 14:09:22.520012
4631,3,2020,Dinamo-Auto,1,0,1,0,0,0,0,0,0,1,0,1,1,0,1,1.0,0.0,1.0,2,0,2,2.0,0.0,2.0,0,0,0,0,0,0,L,2025-07-27 14:09:22.520101
4632,3,2020,Sfîntul Gheorghe,2,1,1,0,0,0,1,0,1,1,1,0,0,0,0,0.0,0.0,0.0,1,1,0,0.5,1.0,0.0,1,0,1,2,1,1,DL,2025-07-27 14:09:22.520190
3616,3,2020,Desna,1,0,1,0,0,0,0,0,0,1,0,1,0,0,0,0.0,0.0,0.0,2,0,2,2.0,0.0,2.0,0,0,0,1,0,1,L,2025-07-27 14:09:22.520283
33,3,2020,Manchester United,9,4,5,5,2,3,3,2,1,1,0,1,19,9,10,2.1,2.3,2.0,7,3,4,0.8,0.8,0.8,5,2,3,1,1,0,WDDWWWWLD,2025-07-27 14:09:22.520372
548,3,2020,Real Sociedad,8,4,4,2,1,1,4,1,3,2,2,0,5,3,2,0.6,0.8,0.5,8,7,1,1.0,1.8,0.3,4,1,3,4,2,2,WLWDDDLD,2025-07-27 14:09:22.520462
4133,3,2020,HB,1,0,1,0,0,0,0,0,0,1,0,1,0,0,0,0.0,0.0,0.0,1,0,1,1.0,0.0,1.0,0,0,0,1,0,1,L,2025-07-27 14:09:22.520552
549,3,2020,Besiktas,1,1,0,0,0,0,1,1,0,0,0,0,1,1,0,1.0,1.0,0.0,1,1,0,1.0,1.0,0.0,0,0,0,0,0,0,D,2025-07-27 14:09:22.520645
551,3,2020,FC Basel 1893,3,2,1,2,1,1,0,0,0,1,1,0,6,4,2,2.0,2.0,2.0,6,5,1,2.0,2.5,1.0,0,0,0,0,0,0,WWL,2025-07-27 14:09:22.520733
552,3,2020,Maribor,1,1,0,0,0,0,1,1,0,0,0,0,1,1,0,1.0,1.0,0.0,1,1,0,1.0,1.0,0.0,0,0,0,0,0,0,D,2025-07-27 14:09:22.520822
553,3,2020,Olympiakos Piraeus,4,2,2,2,1,1,0,0,0,2,1,1,7,5,2,1.8,2.5,1.0,7,5,2,1.8,2.5,1.0,1,0,1,0,0,0,WLLW,2025-07-27 14:09:22.520913
42,3,2020,Arsenal,14,7,7,9,4,5,3,2,1,2,1,1,33,15,18,2.4,2.1,2.6,13,6,7,0.9,0.9,1.0,4,2,2,2,2,0,WWWWWWDWWLDWLD,2025-07-27 14:09:22.521011
3627,3,2020,Kolos Kovalivka,2,0,2,1,0,1,0,0,0,1,0,1,2,0,2,1.0,0.0,1.0,3,0,3,1.5,0.0,1.5,0,0,0,1,0,1,WL,2025-07-27 14:09:22.521102
556,3,2020,Qarabag,7,3,4,1,0,1,1,1,0,5,2,3,7,4,3,1.0,1.3,0.8,13,7,6,1.9,2.3,1.5,1,0,1,3,0,3,WLLLLDL,2025-07-27 14:09:22.521196
555,3,2020,CSKA Moscow,6,3,3,0,0,0,3,2,1,3,1,2,3,0,3,0.5,0.0,1.0,8,1,7,1.3,0.3,2.3,2,2,0,3,3,0,DDLDLL,2025-07-27 14:09:22.521290
46,3,2020,Leicester,8,4,4,4,3,1,2,0,2,2,1,1,14,9,5,1.8,2.3,1.3,7,2,5,0.9,0.5,1.3,4,3,1,3,1,2,WWWDLWDL,2025-07-27 14:09:22.521378
559,3,2020,FCSB,3,2,1,1,1,0,1,0,1,1,1,0,9,3,6,3.0,1.5,6.0,8,2,6,2.7,1.0,6.0,1,1,0,1,1,0,WDL,2025-07-27 14:09:22.521467
47,3,2020,Tottenham,13,6,7,10,6,4,1,0,1,2,0,2,37,22,15,2.8,3.7,2.1,13,2,11,1.0,0.3,1.6,5,5,0,2,0,2,WWWWLWWDWWWWL,2025-07-27 14:09:22.521543
1072,3,2020,TSV Hartberg,1,0,1,0,0,0,0,0,0,1,0,1,2,0,2,2.0,0.0,2.0,3,0,3,3.0,0.0,3.0,0,0,0,0,0,0,L,2025-07-27 14:09:22.521634
562,3,2020,FC Astana,1,1,0,0,0,0,0,0,0,1,1,0,0,0,0,0.0,0.0,0.0,1,1,0,1.0,1.0,0.0,0,0,0,1,1,0,L,2025-07-27 14:09:22.521726
563,3,2020,Hapoel Beer Sheva,10,6,4,6,5,1,0,0,0,4,1,3,16,13,3,1.6,2.2,0.8,14,5,9,1.4,0.8,2.3,4,4,0,2,0,2,WWWWWLLLLW,2025-07-27 14:09:22.521809
561,3,2020,HNK Rijeka,8,4,4,3,2,1,1,0,1,4,2,2,9,5,4,1.1,1.3,1.0,12,4,8,1.5,1.0,2.0,2,1,1,2,1,1,WWLLLLDW,2025-07-27 14:09:22.521891
565,3,2020,BSC Young Boys,11,6,5,6,4,2,1,0,1,4,2,2,18,13,5,1.6,2.2,1.0,15,8,7,1.4,1.3,1.4,4,2,2,2,1,1,WLDWWLWWWLL,2025-07-27 14:09:22.521979
566,3,2020,Ludogorets,7,3,4,1,0,1,0,0,0,6,3,3,9,3,6,1.3,1.0,1.5,19,8,11,2.7,2.7,2.8,1,0,1,1,0,1,WLLLLLL,2025-07-27 14:09:22.522063
567,3,2020,Plzen,2,1,1,1,1,0,0,0,0,1,0,1,3,3,0,1.5,3.0,0.0,1,0,1,0.5,0.0,1.0,1,1,0,1,0,1,WL,2025-07-27 14:09:22.522143
568,3,2020,Sheriff Tiraspol,1,1,0,0,0,0,1,1,0,0,0,0,1,1,0,1.0,1.0,0.0,1,1,0,1.0,1.0,0.0,0,0,0,0,0,0,D,2025-07-27 14:09:22.522228
4153,3,2020,Valmiera / BSS,1,0,1,0,0,0,0,0,0,1,0,1,0,0,0,0.0,0.0,0.0,3,0,3,3.0,0.0,3.0,0,0,0,1,0,1,L,2025-07-27 14:09:22.522308
569,3,2020,Club Brugge KV,2,1,1,0,0,0,1,0,1,1,1,0,1,0,1,0.5,0.0,1.0,2,1,1,1.0,1.0,1.0,0,0,0,1,1,0,DL,2025-07-27 14:09:22.522388
571,3,2020,Red Bull Salzburg,2,1,1,0,0,0,0,0,0,2,1,1,1,0,1,0.5,0.0,1.0,4,2,2,2.0,2.0,2.0,0,0,0,1,1,0,LL,2025-07-27 14:09:22.522472
572,3,2020,Dynamo Kyiv,4,2,2,1,0,1,1,1,0,2,1,1,2,1,1,0.5,0.5,0.5,5,3,2,1.3,1.5,1.0,1,0,1,2,1,1,DWLL,2025-07-27 14:09:22.522555
573,3,2020,FK Partizan,3,1,2,2,1,1,0,0,0,1,0,1,3,1,2,1.0,1.0,1.0,2,0,2,0.7,0.0,1.0,2,1,1,0,0,0,WWL,2025-07-27 14:09:22.522640
575,3,2020,AEK Athens FC,8,4,4,3,1,2,0,0,0,5,3,2,10,5,5,1.3,1.3,1.3,16,10,6,2.0,2.5,1.5,1,0,1,3,1,2,WWLLWLLL,2025-07-27 14:09:22.522723
4160,3,2020,Rīgas FS,1,0,1,0,0,0,0,0,0,1,0,1,0,0,0,0.0,0.0,0.0,1,0,1,1.0,0.0,1.0,0,0,0,1,0,1,L,2025-07-27 14:09:22.522805
577,3,2020,FK Kukesi,2,2,0,1,1,0,0,0,0,1,1,0,2,2,0,1.0,1.0,0.0,5,5,0,2.5,2.5,0.0,0,0,0,1,1,0,WL,2025-07-27 14:09:22.522893
576,3,2020,Budapest Honved,2,2,0,1,1,0,0,0,0,1,1,0,2,2,0,1.0,1.0,0.0,3,3,0,1.5,1.5,0.0,0,0,0,1,1,0,WL,2025-07-27 14:09:22.522974
579,3,2020,Buducnost Podgorica,2,0,2,1,0,1,0,0,0,1,0,1,2,0,2,1.0,0.0,1.0,2,0,2,1.0,0.0,1.0,1,0,1,0,0,0,WL,2025-07-27 14:09:22.523055
1088,3,2020,Dynamo,1,0,1,0,0,0,0,0,0,1,0,1,1,0,1,1.0,0.0,1.0,2,0,2,2.0,0.0,2.0,0,0,0,0,0,0,L,2025-07-27 14:09:22.523153
582,3,2020,Alashkert,1,1,0,0,0,0,0,0,0,1,1,0,0,0,0,0.0,0.0,0.0,1,1,0,1.0,1.0,0.0,0,0,0,1,1,0,L,2025-07-27 14:09:22.523235
583,3,2020,Linfield,1,1,0,0,0,0,0,0,0,1,1,0,0,0,0,0.0,0.0,0.0,1,1,0,1.0,1.0,0.0,0,0,0,1,1,0,L,2025-07-27 14:09:22.523320
584,3,2020,Dundalk,9,4,5,2,1,1,1,0,1,6,3,3,13,7,6,1.4,1.8,1.2,21,10,11,2.3,2.5,2.2,1,0,1,1,0,1,WDWLLLLLL,2025-07-27 14:09:22.523400
586,3,2020,FK Zalgiris Vilnius,2,1,1,1,1,0,0,0,0,1,0,1,3,2,1,1.5,2.0,1.0,3,0,3,1.5,0.0,3.0,1,1,0,0,0,0,WL,2025-07-27 14:09:22.523483
588,3,2020,Zrinjski,3,1,2,2,1,1,1,0,1,0,0,0,8,3,5,2.7,3.0,2.5,4,0,4,1.3,0.0,2.0,1,1,0,0,0,0,WWD,2025-07-27 14:09:22.523563
591,3,2020,FC Santa Coloma,1,1,0,0,0,0,1,1,0,0,0,0,0,0,0,0.0,0.0,0.0,0,0,0,0.0,0.0,0.0,1,1,0,1,1,0,D,2025-07-27 14:09:22.523643
79,3,2020,Lille,8,4,4,3,1,2,2,2,0,3,1,2,16,6,10,2.0,1.5,2.5,12,6,6,1.5,1.5,1.5,1,0,1,0,0,0,WDWDWLLL,2025-07-27 14:09:22.523722
593,3,2020,Europa Fc,1,0,1,0,0,0,0,0,0,1,0,1,1,0,1,1.0,0.0,1.0,2,0,2,2.0,0.0,2.0,0,0,0,0,0,0,L,2025-07-27 14:09:22.523807
84,3,2020,Nice,6,3,3,1,1,0,0,0,0,5,2,3,8,4,4,1.3,1.3,1.3,16,6,10,2.7,2.0,3.3,1,1,0,1,0,1,LWLLLL,2025-07-27 14:09:22.523886
2646,3,2020,TSC Backa Topola,2,1,1,1,0,1,1,1,0,0,0,0,8,6,2,4.0,6.0,2.0,6,6,0,3.0,6.0,0.0,1,0,1,0,0,0,WD,2025-07-27 14:09:22.523973
598,3,2020,FK Crvena Zvezda,9,4,5,4,2,2,4,2,2,1,0,1,14,9,5,1.6,2.3,1.0,8,4,4,0.9,1.0,0.8,3,1,2,3,1,2,WLWWWDDDD,2025-07-27 14:09:22.524057
599,3,2020,Zorya Luhansk,6,3,3,2,1,1,0,0,0,4,2,2,6,3,3,1.0,1.0,1.0,11,6,5,1.8,2.0,1.7,2,1,1,2,0,2,LLLWWL,2025-07-27 14:09:22.524138
602,3,2020,Apollon Limassol,3,2,1,2,1,1,0,0,0,1,1,0,6,5,1,2.0,2.5,1.0,6,6,0,2.0,3.0,0.0,1,0,1,1,1,0,WWL,2025-07-27 14:09:22.524218
604,3,2020,Maccabi Tel Aviv,8,4,4,3,2,1,2,1,1,3,1,2,6,3,3,0.8,0.8,0.8,10,3,7,1.3,0.8,1.8,2,2,0,3,1,2,WWLDDWLL,2025-07-27 14:09:22.524298
93,3,2020,Reims,2,0,2,1,0,1,1,0,1,0,0,0,1,0,1,0.5,0.0,0.5,0,0,0,0.0,0.0,0.0,2,0,2,1,0,1,WD,2025-07-27 14:09:22.524380
608,3,2020,HNK Hajduk Split,2,0,2,1,0,1,0,0,0,1,0,1,1,0,1,0.5,0.0,0.5,2,0,2,1.0,0.0,1.0,1,0,1,1,0,1,WL,2025-07-27 14:09:22.524459
609,3,2020,Shkendija,3,1,2,2,0,2,0,0,0,1,1,0,4,1,3,1.3,1.0,1.5,3,3,0,1.0,3.0,0.0,2,0,2,0,0,0,WWL,2025-07-27 14:09:22.524539
610,3,2020,Fehérvár FC,4,2,2,1,0,1,2,2,0,1,0,1,3,1,2,0.8,0.5,1.0,4,1,3,1.0,0.5,1.5,2,1,1,1,1,0,DWDL,2025-07-27 14:09:22.524617
4195,3,2020,Maccabi Haifa,4,2,2,3,2,1,0,0,0,1,0,1,9,5,4,2.3,2.5,2.0,10,2,8,2.5,1.0,4.0,0,0,0,0,0,0,WWWL,2025-07-27 14:09:22.524702
3684,3,2020,FC Noah,1,0,1,0,0,0,0,0,0,1,0,1,1,0,1,1.0,0.0,1.0,4,0,4,4.0,0.0,4.0,0,0,0,0,0,0,L,2025-07-27 14:09:22.524783
4197,3,2020,Mura,3,2,1,2,1,1,0,0,0,1,1,0,8,4,4,2.7,2.0,4.0,5,5,0,1.7,2.5,0.0,2,1,1,0,0,0,WWL,2025-07-27 14:09:22.524862
3686,3,2020,Shirak,1,0,1,0,0,0,0,0,0,1,0,1,0,0,0,0.0,0.0,0.0,3,0,3,3.0,0.0,3.0,0,0,0,1,0,1,L,2025-07-27 14:09:22.524946
3683,3,2020,Ararat-Armenia,3,3,0,2,2,0,0,0,0,1,1,0,6,6,0,2.0,2.0,0.0,5,5,0,1.7,1.7,0.0,1,1,0,0,0,0,WWL,2025-07-27 14:09:22.525025
1124,3,2020,OFI,1,1,0,0,0,0,0,0,0,1,1,0,0,0,0,0.0,0.0,0.0,1,1,0,1.0,1.0,0.0,0,0,0,1,1,0,L,2025-07-27 14:09:22.525105
1123,3,2020,Aris Thessalonikis,1,1,0,0,0,0,0,0,0,1,1,0,1,1,0,1.0,1.0,0.0,2,2,0,2.0,2.0,0.0,0,0,0,0,0,0,L,2025-07-27 14:09:22.525186
616,3,2020,NK Osijek,1,1,0,0,0,0,0,0,0,1,1,0,1,1,0,1.0,1.0,0.0,2,2,0,2.0,2.0,0.0,0,0,0,0,0,0,L,2025-07-27 14:09:22.525272
1122,3,2020,FK Jablonec,1,0,1,0,0,0,0,0,0,1,0,1,3,0,3,3.0,0.0,3.0,5,0,5,5.0,0.0,5.0,0,0,0,0,0,0,L,2025-07-27 14:09:22.525352
612,3,2020,Suduva Marijampole,1,0,1,0,0,0,0,0,0,1,0,1,0,0,0,0.0,0.0,0.0,2,0,2,2.0,0.0,2.0,0,0,0,1,0,1,L,2025-07-27 14:09:22.525441
620,3,2020,Dinamo Zagreb,13,7,6,8,5,3,2,1,1,3,1,2,20,11,9,1.5,1.6,1.5,9,3,6,0.7,0.4,1.0,7,4,3,4,2,2,WDDWWWWWWLWLL,2025-07-27 14:09:22.525500
619,3,2020,PAOK,6,3,3,1,1,0,3,2,1,2,0,2,8,5,3,1.3,1.7,1.0,7,2,5,1.2,0.7,1.7,2,1,1,2,1,1,DDWLLD,2025-07-27 14:09:22.525566
621,3,2020,FC Krasnodar,2,1,1,0,0,0,0,0,0,2,1,1,2,2,0,1.0,2.0,0.0,4,3,1,2.0,3.0,1.0,0,0,0,1,0,1,LL,2025-07-27 14:09:22.525633
626,3,2020,Fola Esch,1,0,1,0,0,0,0,0,0,1,0,1,3,0,3,3.0,0.0,3.0,4,0,4,4.0,0.0,4.0,0,0,0,0,0,0,L,2025-07-27 14:09:22.525702
628,3,2020,Sparta Praha,6,3,3,2,1,1,0,0,0,4,2,2,10,5,5,1.7,1.7,1.7,12,6,6,2.0,2.0,2.0,0,0,0,2,1,1,LLWWLL,2025-07-27 14:09:22.525786
631,3,2020,Gent,6,3,3,0,0,0,0,0,0,6,3,3,4,2,2,0.7,0.7,0.7,15,8,7,2.5,2.7,2.3,0,0,0,2,1,1,LLLLLL,2025-07-27 14:09:22.525876
632,3,2020,Universitatea Craiova,1,0,1,0,0,0,0,0,0,1,0,1,1,0,1,1.0,0.0,1.0,2,0,2,2.0,0.0,2.0,0,0,0,0,0,0,L,2025-07-27 14:09:22.525961
638,3,2020,FK Trakai,2,2,0,1,1,0,0,0,0,1,1,0,4,4,0,2.0,2.0,0.0,7,7,0,3.5,3.5,0.0,0,0,0,0,0,0,WL,2025-07-27 14:09:22.526060
645,3,2020,Galatasaray,3,1,2,2,1,1,0,0,0,1,0,1,6,2,4,2.0,2.0,2.0,3,0,3,1.0,0.0,1.5,1,1,0,0,0,0,WWL,2025-07-27 14:09:22.526133
2184,3,2020,Servette FC,2,2,0,1,1,0,0,0,0,1,1,0,3,3,0,1.5,1.5,0.0,1,1,0,0.5,0.5,0.0,1,1,0,1,1,0,WL,2025-07-27 14:09:22.526196
1163,3,2020,Ilves,1,0,1,0,0,0,1,0,1,0,0,0,2,0,2,2.0,0.0,2.0,2,0,2,2.0,0.0,2.0,0,0,0,0,0,0,D,2025-07-27 14:09:22.526272
1164,3,2020,Inter Turku,1,0,1,0,0,0,0,0,0,1,0,1,1,0,1,1.0,0.0,1.0,2,0,2,2.0,0.0,2.0,0,0,0,0,0,0,L,2025-07-27 14:09:22.526347
652,3,2020,Shamrock Rovers,2,2,0,0,0,0,1,1,0,1,1,0,2,2,0,1.0,1.0,0.0,4,4,0,2.0,2.0,0.0,0,0,0,1,1,0,DL,2025-07-27 14:09:22.526425
654,3,2020,Zeljeznicar Sarajevo,1,0,1,0,0,0,0,0,0,1,0,1,1,0,1,1.0,0.0,1.0,3,0,3,3.0,0.0,3.0,0,0,0,0,0,0,L,2025-07-27 14:09:22.526500
1165,3,2020,KuPS,3,2,1,1,1,0,1,1,0,1,0,1,4,3,1,1.3,1.5,1.0,4,1,3,1.3,0.5,3.0,1,1,0,0,0,0,DWL,2025-07-27 14:09:22.526565
656,3,2020,Slovan Bratislava,1,0,1,0,0,0,1,0,1,0,0,0,1,0,1,1.0,0.0,1.0,1,0,1,1.0,0.0,1.0,0,0,0,0,0,0,D,2025-07-27 14:09:22.526652
657,3,2020,Beitar Jerusalem,1,0,1,0,0,0,0,0,0,1,0,1,0,0,0,0.0,0.0,0.0,2,0,2,2.0,0.0,2.0,0,0,0,1,0,1,L,2025-07-27 14:09:22.526741
658,3,2020,Progres Niederkorn,2,2,0,1,1,0,0,0,0,1,1,0,3,3,0,1.5,1.5,0.0,5,5,0,2.5,2.5,0.0,1,1,0,1,1,0,WL,2025-07-27 14:09:22.526829
1169,3,2020,Honka,1,0,1,0,0,0,0,0,0,1,0,1,2,0,2,2.0,0.0,2.0,5,0,5,5.0,0.0,5.0,0,0,0,0,0,0,L,2025-07-27 14:09:22.526908
660,3,2020,FC Vaduz,1,1,0,0,0,0,0,0,0,1,1,0,0,0,0,0.0,0.0,0.0,2,2,0,2.0,2.0,0.0,0,0,0,1,1,0,L,2025-07-27 14:09:22.527010
659,3,2020,Valletta FC,1,1,0,0,0,0,0,0,0,1,1,0,0,0,0,0.0,0.0,0.0,1,1,0,1.0,1.0,0.0,0,0,0,1,1,0,L,2025-07-27 14:09:22.527099
662,3,2020,Kalju Nomme,1,1,0,0,0,0,0,0,0,1,1,0,0,0,0,0.0,0.0,0.0,4,4,0,4.0,4.0,0.0,0,0,0,1,1,0,L,2025-07-27 14:09:22.527195
664,3,2020,Kairat Almaty,2,1,1,1,1,0,0,0,0,1,0,1,5,4,1,2.5,4.0,1.0,3,1,2,1.5,1.0,2.0,0,0,0,0,0,0,WL,2025-07-27 14:09:22.527286
3738,3,2020,Iskra,2,1,1,0,0,0,1,0,1,1,1,0,0,0,0,0.0,0.0,0.0,1,1,0,0.5,1.0,0.0,1,0,1,2,1,1,DL,2025-07-27 14:09:22.527376
667,3,2020,Lincoln Red Imps FC,3,3,0,2,2,0,0,0,0,1,1,0,5,5,0,1.7,1.7,0.0,5,5,0,1.7,1.7,0.0,2,2,0,1,1,0,WWL,2025-07-27 14:09:22.527457
666,3,2020,Keshla FC,1,1,0,0,0,0,1,1,0,0,0,0,0,0,0,0.0,0.0,0.0,0,0,0,0.0,0.0,0.0,1,1,0,1,1,0,D,2025-07-27 14:09:22.527537
669,3,2020,Coleraine FC,3,2,1,1,1,0,2,1,1,0,0,0,4,3,1,1.3,1.5,1.0,3,2,1,1.0,1.0,1.0,1,1,0,0,0,0,WDD,2025-07-27 14:09:22.527626
670,3,2020,Derry City,1,0,1,0,0,0,0,0,0,1,0,1,2,0,2,2.0,0.0,2.0,3,0,3,3.0,0.0,3.0,0,0,0,0,0,0,L,2025-07-27 14:09:22.527704
673,3,2020,Sutjeska,1,0,1,0,0,0,0,0,0,1,0,1,0,0,0,0.0,0.0,0.0,1,0,1,1.0,0.0,1.0,0,0,0,1,0,1,L,2025-07-27 14:09:22.527786
161,3,2020,VfL Wolfsburg,3,1,2,2,1,1,0,0,0,1,0,1,7,2,5,2.3,2.0,2.5,2,0,2,0.7,0.0,1.0,2,1,1,0,0,0,WWL,2025-07-27 14:09:22.527865
676,3,2020,Zeta,2,0,2,1,0,1,0,0,0,1,0,1,3,0,3,1.5,0.0,1.5,4,0,4,2.0,0.0,2.0,0,0,0,1,0,1,WL,2025-07-27 14:09:22.527964
677,3,2020,Olimpija Ljubljana,2,2,0,1,1,0,0,0,0,1,1,0,4,4,0,2.0,2.0,0.0,4,4,0,2.0,2.0,0.0,0,0,0,0,0,0,WL,2025-07-27 14:09:22.528050
678,3,2020,B36 Torshavn,4,2,2,2,1,1,1,1,0,1,0,1,9,6,3,2.3,3.0,1.5,9,5,4,2.3,2.5,2.0,0,0,0,0,0,0,WWDL,2025-07-27 14:09:22.528132
679,3,2020,FK Sarajevo,2,2,0,1,1,0,0,0,0,1,1,0,2,2,0,1.0,1.0,0.0,2,2,0,1.0,1.0,0.0,0,0,0,1,1,0,WL,2025-07-27 14:09:22.528218
680,3,2020,Prishtina,1,0,1,0,0,0,0,0,0,1,0,1,0,0,0,0.0,0.0,0.0,3,0,3,3.0,0.0,3.0,0,0,0,1,0,1,L,2025-07-27 14:09:22.528310
168,3,2020,Bayer Leverkusen,8,4,4,5,3,2,0,0,0,3,1,2,24,14,10,3.0,3.5,2.5,14,5,9,1.8,1.3,2.3,1,1,0,2,1,1,WLWWWWLL,2025-07-27 14:09:22.528397
682,3,2020,NSI Runavik,2,1,1,1,1,0,0,0,0,1,0,1,5,5,0,2.5,5.0,0.0,7,1,6,3.5,1.0,6.0,0,0,0,1,0,1,WL,2025-07-27 14:09:22.528462
167,3,2020,1899 Hoffenheim,8,4,4,5,3,2,2,0,2,1,1,0,20,11,9,2.5,2.8,2.3,7,3,4,0.9,0.8,1.0,4,2,2,2,1,1,WWWWDWDL,2025-07-27 14:09:22.528528
684,3,2020,FC Differdange 03,1,0,1,0,0,0,0,0,0,1,0,1,0,0,0,0.0,0.0,0.0,3,0,3,3.0,0.0,3.0,0,0,0,1,0,1,L,2025-07-27 14:09:22.528635
687,3,2020,Flora Tallinn,3,1,2,1,1,0,1,0,1,1,0,1,3,2,1,1.0,2.0,0.5,4,1,3,1.3,1.0,1.5,1,0,1,1,0,1,WDL,2025-07-27 14:09:22.528725
692,3,2020,Ordabasy,1,1,0,0,0,0,0,0,0,1,1,0,1,1,0,1.0,1.0,0.0,2,2,0,2.0,2.0,0.0,0,0,0,0,0,0,L,2025-07-27 14:09:22.528800
694,3,2020,Tirana,1,0,1,0,0,0,0,0,0,1,0,1,0,0,0,0.0,0.0,0.0,3,0,3,3.0,0.0,3.0,0,0,0,1,0,1,L,2025-07-27 14:09:22.528866
698,3,2020,St Joseph S Fc,1,1,0,0,0,0,0,0,0,1,1,0,1,1,0,1.0,1.0,0.0,2,2,0,2.0,2.0,0.0,0,0,0,0,0,0,L,2025-07-27 14:09:22.528929
700,3,2020,Tre Penne,1,1,0,0,0,0,0,0,0,1,1,0,1,1,0,1.0,1.0,0.0,3,3,0,3.0,3.0,0.0,0,0,0,0,0,0,L,2025-07-27 14:09:22.528999
701,3,2020,KI Klaksvik,2,1,1,1,1,0,0,0,0,1,0,1,7,6,1,3.5,6.0,1.0,4,1,3,2.0,1.0,3.0,0,0,0,0,0,0,WL,2025-07-27 14:09:22.529088
702,3,2020,Vojvodina,1,0,1,0,0,0,0,0,0,1,0,1,1,0,1,1.0,0.0,1.0,2,0,2,2.0,0.0,2.0,0,0,0,0,0,0,L,2025-07-27 14:09:22.529184
705,3,2020,Dinamo Batumi,1,0,1,0,0,0,0,0,0,1,0,1,0,0,0,0.0,0.0,0.0,3,0,3,3.0,0.0,3.0,0,0,0,1,0,1,L,2025-07-27 14:09:22.529281
194,3,2020,Ajax,6,3,3,4,2,2,1,0,1,1,1,0,11,6,5,1.8,2.0,1.7,5,3,2,0.8,1.0,0.7,2,1,1,0,0,0,WWWWLD,2025-07-27 14:09:22.529368
707,3,2020,FK Ventspils,2,2,0,1,1,0,0,0,0,1,1,0,3,3,0,1.5,1.5,0.0,6,6,0,3.0,3.0,0.0,0,0,0,0,0,0,WL,2025-07-27 14:09:22.529439
195,3,2020,Willem II,2,1,1,1,0,1,0,0,0,1,1,0,5,0,5,2.5,0.0,5.0,4,4,0,2.0,4.0,0.0,1,0,1,1,1,0,WL,2025-07-27 14:09:22.529505
197,3,2020,PSV Eindhoven,10,4,6,7,3,4,0,0,0,3,1,2,23,10,13,2.3,2.5,2.2,15,5,10,1.5,1.3,1.7,3,1,2,0,0,0,WWLWLWWWLW,2025-07-27 14:09:22.529576
2246,3,2020,CFR 1907 Cluj,8,4,4,3,1,2,2,2,0,3,1,2,8,4,4,1.0,1.0,1.0,11,4,7,1.4,1.0,1.8,3,1,2,3,2,1,WWWDLLDL,2025-07-27 14:09:22.529662
2247,3,2020,Apoel Nicosia,4,1,3,2,0,2,1,1,0,1,0,1,8,2,6,2.0,2.0,2.0,4,2,2,1.0,2.0,0.7,1,0,1,1,0,1,WWDL,2025-07-27 14:09:22.529749
2249,3,2020,La Fiorita,1,0,1,0,0,0,0,0,0,1,0,1,0,0,0,0.0,0.0,0.0,1,0,1,1.0,0.0,1.0,0,0,0,1,0,1,L,2025-07-27 14:09:22.529836
201,3,2020,AZ Alkmaar,6,3,3,2,1,1,2,2,0,2,0,2,7,5,2,1.2,1.7,0.7,5,2,3,0.8,0.7,1.0,2,1,1,2,1,1,WWLDDL,2025-07-27 14:09:22.529931
715,3,2020,Granada CF,15,7,8,8,4,4,2,1,1,5,2,3,21,8,13,1.4,1.1,1.6,12,4,8,0.8,0.6,1.0,7,4,3,5,3,2,WWWWDWWLDWLWLLL,2025-07-27 14:09:22.530004
2256,3,2020,Laci,2,1,1,0,0,0,1,0,1,1,1,0,1,1,0,0.5,1.0,0.0,2,2,0,1.0,2.0,0.0,1,0,1,1,0,1,DL,2025-07-27 14:09:22.530077
2257,3,2020,Dunajska Streda,3,1,2,2,1,1,0,0,0,1,0,1,7,5,2,2.3,5.0,1.0,10,3,7,3.3,3.0,3.5,1,0,1,1,0,1,WWL,2025-07-27 14:09:22.530139
209,3,2020,Feyenoord,6,3,3,1,1,0,2,0,2,3,2,1,4,4,0,0.7,1.3,0.0,8,7,1,1.3,2.3,0.3,2,0,2,4,1,3,DLWDLL,2025-07-27 14:09:22.530213
211,3,2020,Benfica,8,4,4,3,2,1,4,2,2,1,0,1,21,11,10,2.6,2.8,2.5,13,4,9,1.6,1.0,2.3,2,2,0,0,0,0,WWDDWDDL,2025-07-27 14:09:22.530274
2260,3,2020,Tre Fiori,1,0,1,0,0,0,0,0,0,1,0,1,0,0,0,0.0,0.0,0.0,1,0,1,1.0,0.0,1.0,0,0,0,1,0,1,L,2025-07-27 14:09:22.530358
550,3,2020,Shakhtar Donetsk,4,2,2,2,1,1,0,0,0,2,1,1,4,2,2,1.0,1.0,1.0,5,2,3,1.3,1.0,1.5,2,1,1,1,0,1,WWLL,2025-07-27 14:09:22.530456
2262,3,2020,Dinamo Tbilisi,2,0,2,1,0,1,0,0,0,1,0,1,2,0,2,1.0,0.0,1.0,6,0,6,3.0,0.0,3.0,1,0,1,0,0,0,WL,2025-07-27 14:09:22.530553
2265,3,2020,Shkupi 1927,1,0,1,0,0,0,0,0,0,1,0,1,1,0,1,1.0,0.0,1.0,2,0,2,2.0,0.0,2.0,0,0,0,0,0,0,L,2025-07-27 14:09:22.530644
217,3,2020,SC Braga,8,4,4,4,2,2,1,1,0,3,1,2,15,8,7,1.9,2.0,1.8,15,5,10,1.9,1.3,2.5,2,2,0,2,1,1,WWLDWWLL,2025-07-27 14:09:22.530734
2268,3,2020,UE Engordany,1,1,0,0,0,0,0,0,0,1,1,0,1,1,0,1.0,1.0,0.0,3,3,0,3.0,3.0,0.0,0,0,0,0,0,0,L,2025-07-27 14:09:22.530829
733,3,2020,Standard Liege,9,6,3,4,4,0,1,1,0,4,1,3,14,11,3,1.6,1.8,1.0,16,7,9,1.8,1.2,3.0,1,1,0,2,1,1,WWWLLLWLD,2025-07-27 14:09:22.530913
2270,3,2020,Neftchi Baku,2,2,0,1,1,0,0,0,0,1,1,0,3,3,0,1.5,1.5,0.0,4,4,0,2.0,2.0,0.0,0,0,0,0,0,0,WL,2025-07-27 14:09:22.530980
2271,3,2020,Petrocub,1,1,0,0,0,0,0,0,0,1,1,0,0,0,0,0.0,0.0,0.0,2,2,0,2.0,2.0,0.0,0,0,0,1,1,0,L,2025-07-27 14:09:22.531047
736,3,2020,Charleroi,2,2,0,1,1,0,0,0,0,1,1,0,3,3,0,1.5,1.5,0.0,3,3,0,1.5,1.5,0.0,0,0,0,0,0,0,WL,2025-07-27 14:09:22.531105
2273,3,2020,FC Levadia Tallinn,1,0,1,0,0,0,0,0,0,1,0,1,3,0,3,3.0,0.0,3.0,4,0,4,4.0,0.0,4.0,0,0,0,0,0,0,L,2025-07-27 14:09:22.531188
226,3,2020,Rio Ave,3,1,2,1,0,1,2,1,1,0,0,0,5,2,3,1.7,2.0,1.5,3,2,1,1.0,2.0,0.5,1,0,1,0,0,0,WDD,2025-07-27 14:09:22.531256
2269,3,2020,Anorthosis,1,0,1,0,0,0,0,0,0,1,0,1,2,0,2,2.0,0.0,2.0,3,0,3,3.0,0.0,3.0,0,0,0,0,0,0,L,2025-07-27 14:09:22.531315
228,3,2020,Sporting CP,2,2,0,1,1,0,0,0,0,1,1,0,2,2,0,1.0,1.0,0.0,4,4,0,2.0,2.0,0.0,1,1,0,0,0,0,WL,2025-07-27 14:09:22.531370
740,3,2020,Antwerp,8,4,4,4,2,2,0,0,0,4,2,2,13,7,6,1.6,1.8,1.5,14,6,8,1.8,1.5,2.0,2,1,1,2,1,1,WWLWWLLL,2025-07-27 14:09:22.531424
5352,3,2020,Glentoran,2,1,1,1,1,0,0,0,0,1,0,1,2,1,1,1.0,1.0,1.0,5,0,5,2.5,0.0,5.0,1,1,0,0,0,0,WL,2025-07-27 14:09:22.531478
4330,3,2020,Renova,2,1,1,1,0,1,0,0,0,1,1,0,1,0,1,0.5,0.0,1.0,1,1,0,0.5,1.0,0.0,1,0,1,1,1,0,WL,2025-07-27 14:09:22.531534
4331,3,2020,Sileks,1,1,0,0,0,0,0,0,0,1,1,0,0,0,0,0.0,0.0,0.0,2,2,0,2.0,2.0,0.0,0,0,0,1,1,0,L,2025-07-27 14:09:22.531625
759,3,2020,Viking,1,1,0,0,0,0,0,0,0,1,1,0,0,0,0,0.0,0.0,0.0,2,2,0,2.0,2.0,0.0,0,0,0,1,1,0,L,2025-07-27 14:09:22.531722
3320,3,2020,Teuta Durrës,2,2,0,1,1,0,0,0,0,1,1,0,2,2,0,1.0,1.0,0.0,4,4,0,2.0,2.0,0.0,1,1,0,1,1,0,WL,2025-07-27 14:09:22.531839
247,3,2020,Celtic,8,3,5,3,1,2,1,0,1,4,2,2,12,5,7,1.5,1.7,1.4,19,9,10,2.4,3.0,2.0,2,0,2,0,0,0,WWLDLLLW,2025-07-27 14:09:22.531914
252,3,2020,Aberdeen,3,1,2,2,1,1,0,0,0,1,0,1,8,6,2,2.7,6.0,1.0,1,0,1,0.3,0.0,0.5,2,1,1,1,0,1,WWL,2025-07-27 14:09:22.531975
3840,3,2020,Bohemians,1,0,1,0,0,0,1,0,1,0,0,0,1,0,1,1.0,0.0,1.0,1,0,1,1.0,0.0,1.0,0,0,0,0,0,0,D,2025-07-27 14:09:22.532069
256,3,2020,Motherwell,3,1,2,1,1,0,1,0,1,1,0,1,7,5,2,2.3,5.0,1.0,6,1,5,2.0,1.0,2.5,0,0,0,1,0,1,WDL,2025-07-27 14:09:22.532159
257,3,2020,Rangers,13,6,7,9,4,5,3,1,2,1,1,0,34,13,21,2.6,2.2,3.0,16,9,7,1.2,1.5,1.0,5,1,4,1,1,0,WWWWWDDWWWWDL,2025-07-27 14:09:22.532245
560,3,2020,Slavia Praha,12,6,6,6,3,3,3,2,1,3,1,2,17,8,9,1.4,1.3,1.5,16,7,9,1.3,1.2,1.5,5,3,2,3,2,1,LWWWWLDWDWDL,2025-07-27 14:09:22.532327
4360,3,2020,Celje,1,0,1,0,0,0,0,0,0,1,0,1,0,0,0,0.0,0.0,0.0,1,0,1,1.0,0.0,1.0,0,0,0,1,0,1,L,2025-07-27 14:09:22.532388
779,3,2020,FC Rostov,1,1,0,0,0,0,0,0,0,1,1,0,1,1,0,1.0,1.0,0.0,2,2,0,2.0,2.0,0.0,0,0,0,0,0,0,L,2025-07-27 14:09:22.532489
781,3,2020,Rapid Vienna,6,3,3,2,1,1,1,1,0,3,1,2,11,7,4,1.8,2.3,1.3,13,7,6,2.2,2.3,2.0,0,0,0,1,0,1,LLWWLD,2025-07-27 14:09:22.532585
270,3,2020,FH hafnarfjordur,1,1,0,0,0,0,0,0,0,1,1,0,0,0,0,0.0,0.0,0.0,2,2,0,2.0,2.0,0.0,0,0,0,1,1,0,L,2025-07-27 14:09:22.532654
782,3,2020,Slovan Liberec,9,4,5,5,2,3,1,1,0,3,1,2,12,2,10,1.3,0.5,2.0,14,2,12,1.6,0.5,2.4,4,3,1,3,2,1,WWWWLLLWD,2025-07-27 14:09:22.532738
271,3,2020,KR Reykjavik,1,0,1,0,0,0,0,0,0,1,0,1,1,0,1,1.0,0.0,1.0,2,0,2,2.0,0.0,2.0,0,0,0,0,0,0,L,2025-07-27 14:09:22.532815
3342,3,2020,Inter Club d'Escaldes,1,1,0,0,0,0,0,0,0,1,1,0,0,0,0,0.0,0.0,0.0,1,1,0,1.0,1.0,0.0,0,0,0,1,1,0,L,2025-07-27 14:09:22.532887
276,3,2020,Breidablik,1,0,1,0,0,0,0,0,0,1,0,1,2,0,2,2.0,0.0,2.0,4,0,4,4.0,0.0,4.0,0,0,0,0,0,0,L,2025-07-27 14:09:22.532963
278,3,2020,Vikingur Reykjavik,1,0,1,0,0,0,0,0,0,1,0,1,1,0,1,1.0,0.0,1.0,2,0,2,2.0,0.0,2.0,0,0,0,0,0,0,L,2025-07-27 14:09:22.533041
3872,3,2020,Kauno Žalgiris,1,0,1,0,0,0,0,0,0,1,0,1,1,0,1,1.0,0.0,1.0,6,0,6,6.0,0.0,6.0,0,0,0,0,0,0,L,2025-07-27 14:09:22.533133
3364,3,2020,Borac Banja Luka,2,2,0,1,1,0,0,0,0,1,1,0,1,1,0,0.5,0.5,0.0,2,2,0,1.0,1.0,0.0,1,1,0,1,1,0,WL,2025-07-27 14:09:22.533209
3884,3,2020,Hibernians,2,1,1,1,0,1,0,0,0,1,1,0,2,0,2,1.0,0.0,2.0,1,1,0,0.5,1.0,0.0,1,0,1,1,1,0,WL,2025-07-27 14:09:22.533272
327,3,2020,Bodo/Glimt,3,2,1,2,2,0,0,0,0,1,0,1,11,9,2,3.7,4.5,2.0,5,2,3,1.7,1.0,3.0,0,0,0,0,0,0,WWL,2025-07-27 14:09:22.533352
329,3,2020,Molde,10,5,5,5,3,2,2,1,1,3,1,2,16,9,7,1.6,1.8,1.4,17,8,9,1.7,1.6,1.8,2,1,1,2,1,1,WWLLWDDWLW,2025-07-27 14:09:22.533425
3402,3,2020,Omonia Nicosia,6,3,3,1,1,0,1,0,1,4,2,2,5,3,2,0.8,1.0,0.7,12,5,7,2.0,1.7,2.3,0,0,0,2,1,1,DLLLWL,2025-07-27 14:09:22.533512
331,3,2020,Rosenborg,4,3,1,3,2,1,0,0,0,1,1,0,10,5,5,2.5,1.7,5.0,5,4,1,1.3,1.3,1.0,1,1,0,1,1,0,WWWL,2025-07-27 14:09:22.533620
339,3,2020,Legia Warszawa,2,2,0,1,1,0,0,0,0,1,1,0,2,2,0,1.0,1.0,0.0,3,3,0,1.5,1.5,0.0,1,1,0,1,1,0,WL,2025-07-27 14:09:22.533707
853,3,2020,CSKA Sofia,10,6,4,5,4,1,2,0,2,3,2,1,13,10,3,1.3,1.7,0.8,10,6,4,1.0,1.0,1.0,3,1,2,5,2,3,WWWWLDLLDW,2025-07-27 14:09:22.533794
854,3,2020,Slavia Sofia,1,0,1,0,0,0,0,0,0,1,0,1,1,0,1,1.0,0.0,1.0,2,0,2,2.0,0.0,2.0,0,0,0,0,0,0,L,2025-07-27 14:09:22.533882
2391,3,2020,Puskas Academy,1,0,1,0,0,0,0,0,0,1,0,1,0,0,0,0.0,0.0,0.0,3,0,3,3.0,0.0,3.0,0,0,0,1,0,1,L,2025-07-27 14:09:22.533992
858,3,2020,Lokomotiv Plovdiv,2,1,1,1,0,1,0,0,0,1,1,0,2,1,1,1.0,1.0,1.0,2,2,0,1.0,2.0,0.0,1,0,1,0,0,0,WL,2025-07-27 14:09:22.534082
347,3,2020,Lech Poznan,10,4,6,5,2,3,0,0,0,5,2,3,19,8,11,1.9,2.0,1.8,15,7,8,1.5,1.8,1.3,3,1,2,3,1,2,WWWWLLWLLL,2025-07-27 14:09:22.534166
349,3,2020,Piast Gliwice,3,1,2,2,1,1,0,0,0,1,0,1,5,3,2,1.7,3.0,1.0,5,2,3,1.7,2.0,1.5,1,0,1,1,0,1,WWL,2025-07-27 14:09:22.534253
350,3,2020,Cracovia Krakow,1,0,1,0,0,0,0,0,0,1,0,1,0,0,0,0.0,0.0,0.0,2,0,2,2.0,0.0,2.0,0,0,0,1,0,1,L,2025-07-27 14:09:22.534340
352,3,2020,Bala Town,2,0,2,1,0,1,0,0,0,1,0,1,1,0,1,0.5,0.0,0.5,2,0,2,1.0,0.0,1.0,1,0,1,1,0,1,WL,2025-07-27 14:09:22.534430
354,3,2020,The New Saints,2,1,1,1,1,0,1,0,1,0,0,0,5,3,2,2.5,3.0,2.0,3,1,2,1.5,1.0,2.0,0,0,0,0,0,0,WD,2025-07-27 14:09:22.534502
357,3,2020,GAP Connah S Quay FC,1,1,0,0,0,0,0,0,0,1,1,0,0,0,0,0.0,0.0,0.0,1,1,0,1.0,1.0,0.0,0,0,0,1,1,0,L,2025-07-27 14:09:22.534563
361,3,2020,Barry Town,1,0,1,0,0,0,0,0,0,1,0,1,1,0,1,1.0,0.0,1.0,5,0,5,5.0,0.0,5.0,0,0,0,0,0,0,L,2025-07-27 14:09:22.534625
363,3,2020,Hammarby FF,2,2,0,1,1,0,0,0,0,1,1,0,3,3,0,1.5,1.5,0.0,3,3,0,1.5,1.5,0.0,1,1,0,1,1,0,WL,2025-07-27 14:09:22.534695
364,3,2020,Djurgardens IF,2,2,0,1,1,0,0,0,0,1,1,0,2,2,0,1.0,1.0,0.0,2,2,0,1.0,1.0,0.0,0,0,0,1,1,0,WL,2025-07-27 14:09:22.534768
366,3,2020,IFK Goteborg,1,1,0,0,0,0,0,0,0,1,1,0,1,1,0,1.0,1.0,0.0,2,2,0,2.0,2.0,0.0,0,0,0,0,0,0,L,2025-07-27 14:09:22.534840
375,3,2020,Malmo FF,4,3,1,3,2,1,0,0,0,1,1,0,10,8,2,2.5,2.7,2.0,3,3,0,0.8,1.0,0.0,3,2,1,0,0,0,WWWL,2025-07-27 14:09:22.534910
5503,3,2020,Sumqayıt,1,1,0,0,0,0,0,0,0,1,1,0,0,0,0,0.0,0.0,0.0,2,2,0,2.0,2.0,0.0,0,0,0,1,1,0,L,2025-07-27 14:09:22.534978
386,3,2020,Dinamo Brest,1,1,0,0,0,0,0,0,0,1,1,0,0,0,0,0.0,0.0,0.0,2,2,0,2.0,2.0,0.0,0,0,0,1,1,0,L,2025-07-27 14:09:22.535036
388,3,2020,Bate Borisov,1,0,1,0,0,0,0,0,0,1,0,1,0,0,0,0.0,0.0,0.0,2,0,2,2.0,0.0,2.0,0,0,0,1,0,1,L,2025-07-27 14:09:22.535104
392,3,2020,Shakhter Soligorsk,1,1,0,0,0,0,1,1,0,0,0,0,0,0,0,0.0,0.0,0.0,0,0,0,0.0,0.0,0.0,1,1,0,1,1,0,D,2025-07-27 14:09:22.535190
394,3,2020,Dinamo Minsk,1,1,0,0,0,0,0,0,0,1,1,0,0,0,0,0.0,0.0,0.0,2,2,0,2.0,2.0,0.0,0,0,0,1,1,0,L,2025-07-27 14:09:22.535272
10124,3,2020,Riga,2,2,0,1,1,0,0,0,0,1,1,0,1,1,0,0.5,0.5,0.0,1,1,0,0.5,0.5,0.0,1,1,0,1,1,0,WL,2025-07-27 14:09:22.535370
396,3,2020,Sonderjyske,1,0,1,0,0,0,0,0,0,1,0,1,0,0,0,0.0,0.0,0.0,3,0,3,3.0,0.0,3.0,0,0,0,1,0,1,L,2025-07-27 14:09:22.535456
400,3,2020,FC Copenhagen,3,2,1,2,1,1,0,0,0,1,1,0,5,3,2,1.7,1.5,2.0,2,1,1,0.7,0.5,1.0,1,1,0,1,1,0,WWL,2025-07-27 14:09:22.535528
406,3,2020,Aarhus,2,1,1,1,1,0,0,0,0,1,0,1,5,5,0,2.5,5.0,0.0,5,2,3,2.5,2.0,3.0,0,0,0,1,0,1,WL,2025-07-27 14:09:22.535592
3500,3,2020,Lokomotivi Tbilisi,3,2,1,2,2,0,0,0,0,1,0,1,4,4,0,1.3,2.0,0.0,4,2,2,1.3,1.0,2.0,0,0,0,1,0,1,WWL,2025-07-27 14:09:22.535664
3502,3,2020,Saburtalo,1,0,1,0,0,0,0,0,0,1,0,1,1,0,1,1.0,0.0,1.0,5,0,5,5.0,0.0,5.0,0,0,0,0,0,0,L,2025-07-27 14:09:22.535752
3528,3,2020,Paide,1,0,1,0,0,0,0,0,0,1,0,1,0,0,0,0.0,0.0,0.0,2,0,2,2.0,0.0,2.0,0,0,0,1,0,1,L,2025-07-27 14:09:22.535845
14281,3,2020,Drita,2,0,2,1,0,1,0,0,0,1,0,1,2,0,2,1.0,0.0,1.0,2,0,2,1.0,0.0,1.0,1,0,1,1,0,1,WL,2025-07-27 14:09:22.535930
4562,3,2020,Kaisar,1,1,0,0,0,0,0,0,0,1,1,0,1,1,0,1.0,1.0,0.0,4,4,0,4.0,4.0,0.0,0,0,0,0,0,0,L,2025-07-27 14:09:22.536025
3549,3,2020,Ružomberok,1,0,1,0,0,0,0,0,0,1,0,1,0,0,0,0.0,0.0,0.0,3,0,3,3.0,0.0,3.0,0,0,0,1,0,1,L,2025-07-27 14:09:22.536115
3554,3,2020,Žilina,1,0,1,0,0,0,0,0,0,1,0,1,1,0,1,1.0,0.0,1.0,3,0,3,3.0,0.0,3.0,0,0,0,0,0,0,L,2025-07-27 14:09:22.536206
12772,3,2020,Gjilani,2,1,1,1,0,1,0,0,0,1,1,0,3,0,3,1.5,0.0,3.0,3,2,1,1.5,2.0,1.0,0,0,0,1,1,0,WL,2025-07-27 14:09:22.536297
996,3,2020,Alanyaspor,1,0,1,0,0,0,0,0,0,1,0,1,0,0,0,0.0,0.0,0.0,1,0,1,1.0,0.0,1.0,0,0,0,1,0,1,L,2025-07-27 14:09:22.536392
489,3,2020,AC Milan,13,6,7,6,3,3,5,1,4,2,2,0,23,11,12,1.8,1.8,1.7,16,9,7,1.2,1.5,1.0,3,1,2,2,2,0,WWDWWLDWWDDDL,2025-07-27 14:09:22.536481
1002,3,2020,Sivasspor,6,3,3,2,1,1,0,0,0,4,2,2,9,3,6,1.5,1.0,2.0,11,3,8,1.8,1.0,2.7,1,1,0,2,1,1,LLWWLL,2025-07-27 14:09:22.536573
492,3,2020,Napoli,8,4,4,4,2,2,2,1,1,2,1,1,9,5,4,1.1,1.3,1.0,7,3,4,0.9,0.8,1.0,2,1,1,2,1,1,LWWWDDLW,2025-07-27 14:09:22.536667
2032,3,2020,Union Titus Petange,1,0,1,0,0,0,0,0,0,1,0,1,0,0,0,0.0,0.0,0.0,2,0,2,2.0,0.0,2.0,0,0,0,1,0,1,L,2025-07-27 14:09:22.536753
497,3,2020,AS Roma,14,7,7,10,5,5,2,2,0,2,0,2,31,18,13,2.2,2.6,1.9,17,5,12,1.2,0.7,1.7,5,3,2,1,1,0,WDWWWLWWWWWDLW,2025-07-27 14:09:22.536846
1011,3,2020,FC ST. Gallen,1,1,0,0,0,0,0,0,0,1,1,0,0,0,0,0.0,0.0,0.0,1,1,0,1.0,1.0,0.0,0,0,0,1,1,0,L,2025-07-27 14:09:22.536931
1017,3,2020,NK Lokomotiva Zagreb,1,0,1,0,0,0,0,0,0,1,0,1,0,0,0,0.0,0.0,0.0,5,0,5,5.0,0.0,5.0,0,0,0,1,0,1,L,2025-07-27 14:09:22.537029
257,3,2021,Rangers,17,8,9,7,6,1,5,1,4,5,1,4,24,16,8,1.4,2.0,0.9,16,6,10,0.9,0.8,1.1,5,4,1,5,1,4,WDLLWDWDWDWLLWLWD,2025-07-27 14:09:22.537111
258,3,2021,ST Johnstone,2,1,1,0,0,0,1,0,1,1,1,0,3,2,1,1.5,2.0,1.0,5,4,1,2.5,4.0,1.0,0,0,0,0,0,0,DL,2025-07-27 14:09:22.537194
645,3,2021,Galatasaray,12,6,6,5,3,2,6,2,4,1,1,0,16,10,6,1.3,1.7,1.0,10,7,3,0.8,1.2,0.5,5,1,4,3,0,3,DWDWWDWDWDDL,2025-07-27 14:09:22.537279
649,3,2021,HJK helsinki,4,2,2,1,1,0,1,0,1,2,1,1,7,5,2,1.8,2.5,1.0,8,5,3,2.0,2.5,1.5,1,1,0,1,0,1,DWLL,2025-07-27 14:09:22.537366
651,3,2021,Ferencvarosi TC,6,3,3,1,1,0,0,0,0,5,2,3,5,4,1,0.8,1.3,0.3,12,6,6,2.0,2.0,2.0,1,1,0,2,0,2,LLLLLW,2025-07-27 14:09:22.537447
781,3,2021,Rapid Vienna,10,5,5,5,3,2,0,0,0,5,2,3,14,8,6,1.4,1.6,1.2,13,4,9,1.3,0.8,1.8,3,2,1,3,2,1,WLWWLLWLLW,2025-07-27 14:09:22.537529
397,3,2021,FC Midtjylland,6,3,3,2,1,1,3,2,1,1,0,1,7,5,2,1.2,1.7,0.7,7,4,3,1.2,1.3,1.0,2,0,2,1,0,1,DLDWWD,2025-07-27 14:09:22.537608
656,3,2021,Slovan Bratislava,4,2,2,1,0,1,2,2,0,1,0,1,6,3,3,1.5,1.5,1.5,7,3,4,1.8,1.5,2.0,0,0,0,1,0,1,WDLD,2025-07-27 14:09:22.537669
401,3,2021,Randers FC,2,1,1,0,0,0,1,1,0,1,0,1,2,1,1,1.0,1.0,1.0,3,1,2,1.5,1.0,2.0,0,0,0,0,0,0,DL,2025-07-27 14:09:22.537757
529,3,2021,Barcelona,6,3,3,2,0,2,3,2,1,1,1,0,10,3,7,1.7,1.0,2.3,8,4,4,1.3,1.3,1.3,1,1,0,1,1,0,DWDWDL,2025-07-27 14:09:22.537837
407,3,2021,Brondby,6,3,3,0,0,0,2,2,0,4,1,3,2,2,0,0.3,0.7,0.0,11,4,7,1.8,1.3,2.3,1,1,0,4,1,3,DLLDLL,2025-07-27 14:09:22.537924
664,3,2021,Kairat Almaty,2,1,1,0,0,0,1,1,0,1,0,1,2,0,2,1.0,0.0,2.0,3,0,3,1.5,0.0,3.0,1,1,0,1,1,0,DL,2025-07-27 14:09:22.538010
536,3,2021,Sevilla,4,2,2,2,2,0,0,0,0,2,0,2,4,4,0,1.0,2.0,0.0,4,1,3,1.0,0.5,1.5,1,1,0,2,0,2,WLWL,2025-07-27 14:09:22.538092
667,3,2021,Lincoln Red Imps FC,2,1,1,0,0,0,1,0,1,1,1,0,2,1,1,1.0,1.0,1.0,4,3,1,2.0,3.0,1.0,0,0,0,0,0,0,LD,2025-07-27 14:09:22.538180
543,3,2021,Real Betis,10,5,5,4,2,2,3,2,1,3,1,2,17,8,9,1.7,1.6,1.8,17,6,11,1.7,1.2,2.2,2,2,0,2,1,1,WWDLWLWDLD,2025-07-27 14:09:22.538261
548,3,2021,Real Sociedad,8,4,4,2,1,1,4,2,2,2,1,1,12,6,6,1.5,1.5,1.5,11,5,6,1.4,1.3,1.5,2,1,1,0,0,0,DDWDLWDL,2025-07-27 14:09:22.538341
165,3,2021,Borussia Dortmund,2,1,1,0,0,0,1,0,1,1,1,0,4,2,2,2.0,2.0,2.0,6,4,2,3.0,4.0,2.0,0,0,0,0,0,0,LD,2025-07-27 14:09:22.538420
168,3,2021,Bayer Leverkusen,8,4,4,4,3,1,1,0,1,3,1,2,16,9,7,2.0,2.3,1.8,9,4,5,1.1,1.0,1.3,2,1,1,2,1,1,WWDWWLLL,2025-07-27 14:09:22.538503
553,3,2021,Olympiakos Piraeus,10,5,5,4,3,1,1,0,1,5,2,3,14,7,7,1.4,1.4,1.4,14,6,8,1.4,1.2,1.6,3,2,1,2,1,1,WDWWLLWLLL,2025-07-27 14:09:22.538585
169,3,2021,Eintracht Frankfurt,13,7,6,7,2,5,6,5,1,0,0,0,21,10,11,1.6,1.4,1.8,13,7,6,1.0,1.0,1.0,2,1,1,0,0,0,DWWWDDWDDWWWD,2025-07-27 14:09:22.538665
173,3,2021,RB Leipzig,6,3,3,3,1,2,2,2,0,1,0,1,10,4,6,1.7,1.3,2.0,7,3,4,1.2,1.0,1.3,2,1,1,0,0,0,DWDWWL,2025-07-27 14:09:22.538746
558,3,2021,Spartak Moscow,6,3,3,3,1,2,1,0,1,2,2,0,10,5,5,1.7,1.7,1.7,9,6,3,1.5,2.0,1.0,1,0,1,1,1,0,LWLDWW,2025-07-27 14:09:22.538833
687,3,2021,Flora Tallinn,2,1,1,1,1,0,0,0,0,1,0,1,2,2,0,1.0,2.0,0.0,2,1,1,1.0,1.0,1.0,0,0,0,1,0,1,LW,2025-07-27 14:09:22.538913
560,3,2021,Slavia Praha,2,1,1,0,0,0,1,1,0,1,0,1,3,2,1,1.5,2.0,1.0,4,2,2,2.0,2.0,2.0,0,0,0,0,0,0,DL,2025-07-27 14:09:22.538993
48,3,2021,West Ham,12,6,6,6,3,3,2,1,1,4,2,2,18,9,9,1.5,1.5,1.5,8,4,4,0.7,0.7,0.7,6,3,3,3,1,2,WWWDWLLWDWLL,2025-07-27 14:09:22.539077
46,3,2021,Leicester,6,3,3,2,1,1,2,2,0,2,0,2,12,6,6,2.0,2.0,2.0,11,4,7,1.8,1.3,2.3,0,0,0,1,0,1,DLWDWL,2025-07-27 14:09:22.539177
566,3,2021,Ludogorets,6,3,3,0,0,0,2,1,1,4,2,2,3,0,3,0.5,0.0,1.0,8,2,6,1.3,0.7,2.0,1,1,0,4,3,1,DLLLLD,2025-07-27 14:09:22.539259
568,3,2021,Sheriff Tiraspol,2,1,1,1,1,0,0,0,0,1,0,1,2,2,0,1.0,2.0,0.0,2,0,2,1.0,0.0,2.0,1,1,0,1,0,1,WL,2025-07-27 14:09:22.539340
197,3,2021,PSV Eindhoven,6,3,3,2,1,1,2,1,1,2,1,1,9,5,4,1.5,1.7,1.3,8,4,4,1.3,1.3,1.3,2,1,1,2,0,2,DWLDWL,2025-07-27 14:09:22.539423
582,3,2021,Alashkert,4,2,2,1,1,0,2,1,1,1,0,1,3,3,0,0.8,1.5,0.0,3,2,1,0.8,1.0,0.5,2,1,1,3,1,2,DWLD,2025-07-27 14:09:22.539507
2246,3,2021,CFR 1907 Cluj,2,1,1,0,0,0,0,0,0,2,1,1,1,1,0,0.5,1.0,0.0,6,2,4,3.0,2.0,4.0,0,0,0,1,0,1,LL,2025-07-27 14:09:22.539586
201,3,2021,AZ Alkmaar,2,1,1,1,1,0,0,0,0,1,0,1,2,2,0,1.0,2.0,0.0,3,1,2,1.5,1.0,2.0,0,0,0,1,0,1,LW,2025-07-27 14:09:22.539665
3402,3,2021,Omonia Nicosia,4,2,2,2,2,0,0,0,0,2,0,2,6,5,1,1.5,2.5,0.5,6,2,4,1.5,1.0,2.0,1,1,0,1,0,1,WLWL,2025-07-27 14:09:22.539749
586,3,2021,FK Zalgiris Vilnius,2,1,1,0,0,0,1,0,1,1,1,0,0,0,0,0.0,0.0,0.0,1,1,0,0.5,1.0,0.0,1,0,1,2,1,1,DL,2025-07-27 14:09:22.539830
80,3,2021,Lyon,10,5,5,6,2,4,3,2,1,1,1,0,19,8,11,1.9,1.6,2.2,10,5,5,1.0,1.0,1.0,4,2,2,1,1,0,WWWWWDWDDL,2025-07-27 14:09:22.539912
81,3,2021,Marseille,6,3,3,1,1,0,4,2,2,1,0,1,6,3,3,1.0,1.0,1.0,7,2,5,1.2,0.7,1.7,3,2,1,2,1,1,DDDDLW,2025-07-27 14:09:22.539995
339,3,2021,Legia Warszawa,8,4,4,3,2,1,1,0,1,4,2,2,8,4,4,1.0,1.0,1.0,14,6,8,1.8,1.5,2.0,2,1,1,2,1,1,DWWWLLLL,2025-07-27 14:09:22.540076
596,3,2021,Zenit,2,1,1,0,0,0,1,0,1,1,1,0,2,2,0,1.0,2.0,0.0,3,3,0,1.5,3.0,0.0,1,0,1,1,0,1,LD,2025-07-27 14:09:22.540156
597,3,2021,Lokomotiv,6,3,3,0,0,0,2,1,1,4,2,2,2,1,1,0.3,0.3,0.3,9,5,4,1.5,1.7,1.3,0,0,0,4,2,2,DLLDLL,2025-07-27 14:09:22.540235
598,3,2021,FK Crvena Zvezda,10,5,5,6,4,2,2,0,2,2,1,1,14,9,5,1.4,1.8,1.0,9,3,6,0.9,0.6,1.2,3,2,1,2,1,1,WWWWDLWDLW,2025-07-27 14:09:22.540318
599,3,2021,Zorya Luhansk,2,1,1,0,0,0,0,0,0,2,1,1,2,2,0,1.0,2.0,0.0,6,3,3,3.0,3.0,3.0,0,0,0,1,0,1,LL,2025-07-27 14:09:22.540397
212,3,2021,FC Porto,4,2,2,1,1,0,2,0,2,1,1,0,5,2,3,1.3,1.0,1.5,5,2,3,1.3,1.0,1.5,0,0,0,1,1,0,WDLD,2025-07-27 14:09:22.540477
217,3,2021,SC Braga,12,6,6,6,5,1,2,1,1,4,0,4,19,13,6,1.6,2.2,1.0,15,4,11,1.3,0.7,1.8,4,3,1,1,0,1,LWWWLDLWWDWL,2025-07-27 14:09:22.540559
91,3,2021,Monaco,8,4,4,3,2,1,4,2,2,1,0,1,8,4,4,1.0,1.0,1.0,7,2,5,0.9,0.5,1.3,2,2,0,2,1,1,WDWDWDLD,2025-07-27 14:09:22.540641
2269,3,2021,Anorthosis,2,1,1,1,1,0,0,0,0,1,0,1,2,2,0,1.0,2.0,0.0,4,1,3,2.0,1.0,3.0,0,0,0,1,0,1,LW,2025-07-27 14:09:22.540721
2270,3,2021,Neftchi Baku,2,1,1,0,0,0,1,1,0,1,0,1,2,2,0,1.0,2.0,0.0,5,2,3,2.5,2.0,3.0,0,0,0,1,0,1,DL,2025-07-27 14:09:22.540801
1122,3,2021,FK Jablonec,2,1,1,0,0,0,0,0,0,2,1,1,2,2,0,1.0,2.0,0.0,7,4,3,3.5,4.0,3.0,0,0,0,1,0,1,LL,2025-07-27 14:09:22.540887
611,3,2021,Fenerbahce,8,4,4,3,1,2,3,2,1,2,1,1,13,4,9,1.6,1.0,2.3,10,6,4,1.3,1.5,1.0,2,1,1,2,1,1,WWDLDWLD,2025-07-27 14:09:22.540968
740,3,2021,Antwerp,8,4,4,2,2,0,2,0,2,4,2,2,10,3,7,1.3,0.8,1.8,14,4,10,1.8,1.0,2.5,2,2,0,2,2,0,LWLLDLDW,2025-07-27 14:09:22.541047
4197,3,2021,Mura,4,2,2,1,0,1,1,1,0,2,1,1,2,1,1,0.5,0.5,0.5,5,3,2,1.3,1.5,1.0,2,1,1,2,1,1,DWLL,2025-07-27 14:09:22.541131
742,3,2021,Genk,6,3,3,1,0,1,2,1,1,3,2,1,4,2,2,0.7,0.7,0.7,10,6,4,1.7,2.0,1.3,1,0,1,3,2,1,WLLDDL,2025-07-27 14:09:22.541221
487,3,2021,Lazio,8,4,4,2,1,1,4,3,1,2,0,2,10,4,6,1.3,1.0,1.5,7,2,5,0.9,0.5,1.3,4,3,1,3,2,1,LWDDWDLD,2025-07-27 14:09:22.541302
620,3,2021,Dinamo Zagreb,8,4,4,4,2,2,1,1,0,3,1,2,11,5,6,1.4,1.3,1.5,9,4,5,1.1,1.0,1.3,3,1,2,1,1,0,LWLWDWLW,2025-07-27 14:09:22.541381
492,3,2021,Napoli,8,4,4,3,2,1,2,0,2,3,2,1,18,10,8,2.3,2.5,2.0,15,9,6,1.9,2.3,1.5,1,1,0,0,0,0,DLWWLWDL,2025-07-27 14:09:22.541464
499,3,2021,Atalanta,6,3,3,4,2,2,1,0,1,1,1,0,10,5,5,1.7,1.7,1.7,6,5,1,1.0,1.7,0.3,2,0,2,1,1,0,WWWWDL,2025-07-27 14:09:22.541545
628,3,2021,Sparta Praha,6,3,3,2,2,0,1,0,1,3,1,2,6,6,0,1.0,2.0,0.0,9,4,5,1.5,1.3,1.7,3,2,1,3,0,3,DWLLLW,2025-07-27 14:09:22.541628
247,3,2021,Celtic,10,5,5,6,4,2,0,0,0,4,1,3,23,10,13,2.3,2.0,2.6,19,6,13,1.9,1.2,2.6,3,3,0,1,1,0,WWWLLLWWLW,2025-07-27 14:09:22.541706
637,3,2021,Sturm Graz,8,4,4,2,1,1,2,1,1,4,2,2,8,4,4,1.0,1.0,1.0,11,6,5,1.4,1.5,1.3,1,1,0,3,1,2,WWLLLDLD,2025-07-27 14:09:22.541790
3719,3,2022,Slovácko,2,1,1,0,0,0,1,1,0,1,0,1,1,1,0,0.5,1.0,0.0,4,1,3,2.0,1.0,3.0,0,0,0,1,0,1,LD,2025-07-27 14:09:22.541870
649,3,2022,HJK helsinki,10,5,5,3,2,1,2,1,1,5,2,3,7,4,3,0.7,0.8,0.6,14,5,9,1.4,1.0,1.8,3,2,1,4,1,3,WWWDLLDLLL,2025-07-27 14:09:22.541965
651,3,2022,Ferencvarosi TC,10,5,5,4,3,1,1,1,0,5,1,4,12,10,2,1.2,2.0,0.4,14,6,8,1.4,1.2,1.6,2,1,1,4,1,3,WLWWLWDLLL,2025-07-27 14:09:22.542049
652,3,2022,Shamrock Rovers,4,2,2,3,2,1,0,0,0,1,0,1,6,4,2,1.5,2.0,1.0,6,1,5,1.5,0.5,2.5,1,1,0,1,0,1,WWLW,2025-07-27 14:09:22.542134
397,3,2022,FC Midtjylland,8,4,4,2,2,0,3,1,2,3,1,2,13,9,4,1.6,2.3,1.0,13,7,6,1.6,1.8,1.5,1,1,0,2,1,1,LWDDLWDL,2025-07-27 14:09:22.542216
783,3,2022,FC Zurich,10,5,5,5,3,2,0,0,0,5,2,3,13,9,4,1.3,1.8,0.8,17,9,8,1.7,1.8,1.6,3,1,2,2,0,2,WWWWLLLLWL,2025-07-27 14:09:22.542295
656,3,2022,Slovan Bratislava,2,1,1,0,0,0,2,1,1,0,0,0,3,2,1,1.5,2.0,1.0,3,2,1,1.5,2.0,1.0,0,0,0,0,0,0,DD,2025-07-27 14:09:22.542380
529,3,2022,Barcelona,2,1,1,0,0,0,1,1,0,1,0,1,3,2,1,1.5,2.0,1.0,4,2,2,2.0,2.0,2.0,0,0,0,0,0,0,DL,2025-07-27 14:09:22.542459
536,3,2022,Sevilla,9,5,4,4,4,0,3,1,2,2,0,2,14,11,3,1.6,2.2,0.8,8,2,6,0.9,0.4,1.5,3,3,0,2,0,2,WLWLDWDWD,2025-07-27 14:09:22.542552
2073,3,2022,Silkeborg,2,1,1,0,0,0,1,1,0,1,0,1,1,1,0,0.5,1.0,0.0,2,1,1,1.0,1.0,1.0,0,0,0,1,0,1,LD,2025-07-27 14:09:22.542641
543,3,2022,Real Betis,8,4,4,5,2,3,1,1,0,2,1,1,13,7,6,1.6,1.8,1.5,9,4,5,1.1,1.0,1.3,3,1,2,1,1,0,WWWDWWLL,2025-07-27 14:09:22.542729
160,3,2022,SC Freiburg,8,4,4,4,2,2,2,1,1,2,1,1,13,5,8,1.6,1.3,2.0,6,4,2,0.8,1.0,0.5,3,1,2,2,1,1,WWWWDDLL,2025-07-27 14:09:22.542796
33,3,2022,Manchester United,12,6,6,8,4,4,2,1,1,2,1,1,21,12,9,1.8,2.0,1.5,12,5,7,1.0,0.8,1.2,5,2,3,2,1,1,LWWWWWDWWWDL,2025-07-27 14:09:22.542862
548,3,2022,Real Sociedad,8,4,4,5,2,3,1,1,0,2,1,1,10,5,5,1.3,1.3,1.3,4,2,2,0.5,0.5,0.5,5,2,3,3,2,1,WWWWWLLD,2025-07-27 14:09:22.542930
550,3,2022,Shakhtar Donetsk,4,2,2,1,1,0,1,1,0,2,0,2,5,3,2,1.3,1.5,1.0,11,2,9,2.8,1.0,4.5,0,0,0,0,0,0,WLDL,2025-07-27 14:09:22.543019
3623,3,2022,Dnipro-1,2,1,1,0,0,0,0,0,0,2,1,1,1,1,0,0.5,1.0,0.0,5,2,3,2.5,2.0,3.0,0,0,0,1,0,1,LL,2025-07-27 14:09:22.543110
552,3,2022,Maribor,2,1,1,0,0,0,0,0,0,2,1,1,0,0,0,0.0,0.0,0.0,3,2,1,1.5,2.0,1.0,0,0,0,2,1,1,LL,2025-07-27 14:09:22.543213
553,3,2022,Olympiakos Piraeus,10,5,5,0,0,0,6,2,4,4,3,1,7,2,5,0.7,0.4,1.0,16,10,6,1.6,2.0,1.2,1,0,1,4,3,1,DDDDLLLDDL,2025-07-27 14:09:22.543309
42,3,2022,Arsenal,8,4,4,5,3,2,2,1,1,1,0,1,11,6,5,1.4,1.5,1.3,6,1,5,0.8,0.3,1.3,4,3,1,1,0,1,WWWWLWDD,2025-07-27 14:09:22.543377
168,3,2022,Bayer Leverkusen,8,4,4,4,1,3,2,2,0,2,1,1,14,5,9,1.8,1.3,2.3,8,4,4,1.0,1.0,1.0,3,2,1,2,1,1,LWWWDWLD,2025-07-27 14:09:22.543437
556,3,2022,Qarabag,6,3,3,2,1,1,2,2,0,2,0,2,9,4,5,1.5,1.3,1.7,5,1,4,0.8,0.3,1.3,3,2,1,1,1,0,LWWDLD,2025-07-27 14:09:22.543494
566,3,2022,Ludogorets,8,4,4,3,3,0,2,0,2,3,1,2,12,5,7,1.5,1.3,1.8,12,2,10,1.5,0.5,2.5,2,2,0,1,1,0,WDWLDWLL,2025-07-27 14:09:22.543569
182,3,2022,Union Berlin,10,5,5,5,3,2,2,1,1,3,1,2,10,8,2,1.0,1.6,0.4,9,5,4,0.9,1.0,0.8,5,2,3,4,1,3,LLWWWWDWDL,2025-07-27 14:09:22.543655
568,3,2022,Sheriff Tiraspol,8,4,4,2,1,1,2,1,1,4,2,2,4,1,3,0.5,0.3,0.8,10,4,6,1.3,1.0,1.5,4,2,2,6,3,3,DDWLLLLW,2025-07-27 14:09:22.543757
571,3,2022,Red Bull Salzburg,2,1,1,1,1,0,0,0,0,1,0,1,1,1,0,0.5,1.0,0.0,2,0,2,1.0,0.0,2.0,1,1,0,1,0,1,WL,2025-07-27 14:09:22.543827
572,3,2022,Dynamo Kyiv,6,3,3,0,0,0,1,0,1,5,3,2,5,0,5,0.8,0.0,1.7,11,4,7,1.8,1.3,2.3,0,0,0,3,3,0,LLLLDL,2025-07-27 14:09:22.543893
573,3,2022,FK Partizan,2,1,1,0,0,0,1,1,0,1,0,1,3,2,1,1.5,2.0,1.0,4,2,2,2.0,2.0,2.0,0,0,0,0,0,0,LD,2025-07-27 14:09:22.543953
578,3,2022,F91 Dudelange,2,1,1,0,0,0,1,1,0,1,0,1,2,2,0,1.0,2.0,0.0,5,2,3,2.5,2.0,3.0,0,0,0,1,0,1,LD,2025-07-27 14:09:22.544024
194,3,2022,Ajax,2,1,1,0,0,0,1,1,0,1,0,1,1,0,1,0.5,0.0,1.0,3,0,3,1.5,0.0,3.0,1,1,0,1,1,0,DL,2025-07-27 14:09:22.544097
709,3,2022,Pyunik Yerevan,2,1,1,0,0,0,2,1,1,0,0,0,0,0,0,0.0,0.0,0.0,0,0,0,0.0,0.0,0.0,2,1,1,2,1,1,DD,2025-07-27 14:09:22.544189
197,3,2022,PSV Eindhoven,8,4,4,5,3,2,1,1,0,2,0,2,17,10,7,2.1,2.5,1.8,7,1,6,0.9,0.3,1.5,3,3,0,2,0,2,DWWLWWLW,2025-07-27 14:09:22.544282
583,3,2022,Linfield,2,1,1,0,0,0,0,0,0,2,1,1,0,0,0,0.0,0.0,0.0,5,2,3,2.5,2.0,3.0,0,0,0,2,1,1,LL,2025-07-27 14:09:22.544357
327,3,2022,Bodo/Glimt,6,3,3,1,1,0,1,0,1,4,2,2,5,3,2,0.8,1.0,0.7,10,4,6,1.7,1.3,2.0,0,0,0,2,1,1,DWLLLL,2025-07-27 14:09:22.544418
586,3,2022,FK Zalgiris Vilnius,2,1,1,0,0,0,1,1,0,1,0,1,3,3,0,1.5,3.0,0.0,4,3,1,2.0,3.0,1.0,0,0,0,1,0,1,LD,2025-07-27 14:09:22.544487
3402,3,2022,Omonia Nicosia,8,4,4,2,1,1,0,0,0,6,3,3,7,4,3,0.9,1.0,0.8,12,8,4,1.5,2.0,1.0,2,1,1,4,2,2,WWLLLLLL,2025-07-27 14:09:22.544554
209,3,2022,Feyenoord,10,5,5,4,4,0,3,1,2,3,0,3,23,17,6,2.3,3.4,1.2,15,3,12,1.5,0.6,2.4,3,3,0,1,0,1,LWDDLWDWWL,2025-07-27 14:09:22.544613
83,3,2022,Nantes,8,4,4,3,2,1,1,0,1,4,2,2,7,4,3,0.9,1.0,0.8,15,9,6,1.9,2.3,1.5,1,0,1,4,2,2,WLLLWWDL,2025-07-27 14:09:22.544678
598,3,2022,FK Crvena Zvezda,6,3,3,2,2,0,0,0,0,4,1,3,9,6,3,1.5,2.0,1.0,11,3,8,1.8,1.0,2.7,0,0,0,1,1,0,LLWLWL,2025-07-27 14:09:22.544748
2265,3,2022,Shkupi 1927,2,1,1,0,0,0,0,0,0,2,1,1,2,1,1,1.0,1.0,1.0,5,2,3,2.5,2.0,3.0,0,0,0,0,0,0,LL,2025-07-27 14:09:22.544806
602,3,2022,Apollon Limassol,2,1,1,0,0,0,2,1,1,0,0,0,2,1,1,1.0,1.0,1.0,2,1,1,1.0,1.0,1.0,0,0,0,0,0,0,DD,2025-07-27 14:09:22.544863
601,3,2022,Austria Vienna,2,1,1,0,0,0,0,0,0,2,1,1,1,0,1,0.5,0.0,1.0,6,2,4,3.0,2.0,4.0,0,0,0,1,1,0,LL,2025-07-27 14:09:22.544920
217,3,2022,SC Braga,6,3,3,3,2,1,1,0,1,2,1,1,9,4,5,1.5,1.3,1.7,7,3,4,1.2,1.0,1.3,2,1,1,1,0,1,WWLDLW,2025-07-27 14:09:22.544981
91,3,2022,Monaco,8,4,4,4,2,2,1,0,1,3,2,1,14,9,5,1.8,2.3,1.3,13,6,7,1.6,1.5,1.8,1,0,1,2,1,1,WLWLDWWL,2025-07-27 14:09:22.545065
94,3,2022,Rennes,8,4,4,4,2,2,3,2,1,1,0,1,14,7,7,1.8,1.8,1.8,11,5,6,1.4,1.3,1.5,1,0,1,0,0,0,WDWWDDLW,2025-07-27 14:09:22.545156
611,3,2022,Fenerbahce,12,6,6,8,5,3,3,1,2,1,0,1,24,15,9,2.0,2.5,1.5,11,5,6,0.9,0.8,1.0,5,3,2,1,0,1,WDWWWDWWDWLW,2025-07-27 14:09:22.545241
228,3,2022,Sporting CP,6,3,3,1,0,1,4,3,1,1,0,1,9,4,5,1.5,1.3,1.7,6,4,2,1.0,1.3,0.7,1,0,1,1,0,1,DWDDLD,2025-07-27 14:09:22.545339
614,3,2022,AEK Larnaca,10,5,5,4,2,2,3,1,2,3,2,1,16,10,6,1.6,2.0,1.2,14,8,6,1.4,1.6,1.2,2,1,1,1,0,1,WDWWLWLLDD,2025-07-27 14:09:22.545423
631,3,2022,Gent,2,1,1,0,0,0,0,0,0,2,1,1,0,0,0,0.0,0.0,0.0,4,2,2,2.0,2.0,2.0,0,0,0,2,1,1,LL,2025-07-27 14:09:22.545507
487,3,2022,Lazio,6,3,3,2,2,0,2,1,1,2,0,2,9,8,1,1.5,2.7,0.3,11,5,6,1.8,1.7,2.0,1,0,1,2,0,2,WLDDWL,2025-07-27 14:09:22.545586
998,3,2022,Trabzonspor,6,3,3,3,3,0,0,0,0,3,0,3,11,7,4,1.8,2.3,1.3,9,1,8,1.5,0.3,2.7,2,2,0,0,0,0,LWLWLW,2025-07-27 14:09:22.545652
1002,3,2022,Sivasspor,2,1,1,0,0,0,0,0,0,2,1,1,1,0,1,0.5,0.0,1.0,5,2,3,2.5,2.0,3.0,0,0,0,1,1,0,LL,2025-07-27 14:09:22.545714
496,3,2022,Juventus,8,4,4,4,2,2,3,2,1,1,0,1,11,4,7,1.4,1.0,1.8,5,2,3,0.6,0.5,0.8,4,2,2,0,0,0,DWWWWDDL,2025-07-27 14:09:22.545776
1393,3,2022,Union St. Gilloise,10,5,5,5,2,3,3,1,2,2,2,0,19,10,9,1.9,2.0,1.8,15,10,5,1.5,2.0,1.0,3,1,2,1,1,0,WWWDWLDWDL,2025-07-27 14:09:22.545843
497,3,2022,AS Roma,15,7,8,7,6,1,4,0,4,4,1,3,21,16,5,1.4,2.3,0.6,11,4,7,0.7,0.6,0.9,6,4,2,4,0,4,LWLDWWLWWDLWWDD,2025-07-27 14:09:22.545909
375,3,2022,Malmo FF,10,5,5,3,2,1,1,0,1,6,3,3,13,6,7,1.3,1.2,1.4,14,6,8,1.4,1.2,1.6,2,1,1,4,3,1,WDWWLLLLLL,2025-07-27 14:09:22.545982
637,3,2022,Sturm Graz,6,3,3,2,2,0,2,1,1,2,0,2,4,2,2,0.7,0.7,0.7,10,0,10,1.7,0.0,3.3,3,3,0,3,1,2,WLDDWL,2025-07-27 14:09:22.546057
254,3,2022,Heart Of Midlothian,2,1,1,0,0,0,0,0,0,2,1,1,1,0,1,0.5,0.0,1.0,3,1,2,1.5,1.0,2.0,0,0,0,1,1,0,LL,2025-07-27 14:09:22.546133
257,3,2023,Rangers,8,4,4,3,2,1,3,1,2,2,1,1,10,4,6,1.3,1.0,1.5,9,3,6,1.1,0.8,1.5,2,1,1,2,1,1,WLDWDWDL,2025-07-27 14:09:22.546205
1026,3,2023,Lask Linz,8,4,4,2,2,0,1,0,1,5,2,3,9,7,2,1.1,1.8,0.5,14,6,8,1.8,1.5,2.0,1,1,0,2,0,2,WDLLLWLL,2025-07-27 14:09:22.546277
388,3,2023,Bate Borisov,2,1,1,0,0,0,1,1,0,1,0,1,3,2,1,1.5,2.0,1.0,7,2,5,3.5,2.0,5.0,0,0,0,0,0,0,LD,2025-07-27 14:09:22.546344
645,3,2023,Galatasaray,2,1,1,1,1,0,0,0,0,1,0,1,4,3,1,2.0,3.0,1.0,6,2,4,3.0,2.0,4.0,0,0,0,0,0,0,WL,2025-07-27 14:09:22.546401
2184,3,2023,Servette FC,6,3,3,1,1,0,2,1,1,3,1,2,4,3,1,0.7,1.0,0.3,13,4,9,2.2,1.3,3.0,0,0,0,3,1,2,LLDWDL,2025-07-27 14:09:22.546459
649,3,2023,HJK helsinki,2,1,1,0,0,0,0,0,0,2,1,1,2,1,1,1.0,1.0,1.0,4,2,2,2.0,2.0,2.0,0,0,0,0,0,0,LL,2025-07-27 14:09:22.546520
656,3,2023,Slovan Bratislava,2,1,1,1,1,0,0,0,0,1,0,1,4,2,2,2.0,2.0,2.0,7,1,6,3.5,1.0,6.0,0,0,0,0,0,0,WL,2025-07-27 14:09:22.546610
276,3,2023,Breidablik,2,1,1,1,1,0,0,0,0,1,0,1,3,1,2,1.5,1.0,2.0,6,0,6,3.0,0.0,6.0,1,1,0,0,0,0,LW,2025-07-27 14:09:22.546691
533,3,2023,Villarreal,8,4,4,5,3,2,1,1,0,2,0,2,12,7,5,1.5,1.8,1.3,12,3,9,1.5,0.8,2.3,2,2,0,3,1,2,LWWWDWLW,2025-07-27 14:09:22.546768
543,3,2023,Real Betis,6,3,3,3,2,1,0,0,0,3,1,2,9,8,1,1.5,2.7,0.3,7,5,2,1.2,1.7,0.7,1,0,1,2,0,2,LWWWLL,2025-07-27 14:09:22.546851
160,3,2023,SC Freiburg,10,5,5,6,4,2,1,0,1,3,1,2,21,15,6,2.1,3.0,1.2,14,4,10,1.4,0.8,2.0,4,3,1,3,0,3,WLWWWLDWWL,2025-07-27 14:09:22.546948
3491,3,2023,Raków Częstochowa,6,3,3,1,0,1,1,1,0,4,2,2,3,1,2,0.5,0.3,0.7,10,6,4,1.7,2.0,1.3,1,0,1,3,2,1,LLDLWL,2025-07-27 14:09:22.547038
677,3,2023,Olimpija Ljubljana,2,1,1,0,0,0,1,0,1,1,1,0,1,0,1,0.5,0.0,1.0,3,2,1,1.5,2.0,1.0,0,0,0,1,1,0,LD,2025-07-27 14:09:22.547122
550,3,2023,Shakhtar Donetsk,2,1,1,0,0,0,1,1,0,1,0,1,3,2,1,1.5,2.0,1.0,5,2,3,2.5,2.0,3.0,0,0,0,0,0,0,DL,2025-07-27 14:09:22.547201
3623,3,2023,Dnipro-1,2,1,1,0,0,0,1,1,0,1,0,1,1,1,0,0.5,1.0,0.0,4,1,3,2.0,1.0,3.0,0,0,0,1,0,1,LD,2025-07-27 14:09:22.547258
168,3,2023,Bayer Leverkusen,13,6,7,9,5,4,3,1,2,1,0,1,31,21,10,2.4,3.5,1.4,13,6,7,1.0,1.0,1.0,5,2,3,1,0,1,WWWWWWDWWDWDL,2025-07-27 14:09:22.547345
553,3,2023,Olympiakos Piraeus,10,5,5,5,4,1,2,0,2,3,1,2,19,13,6,1.9,2.6,1.2,16,7,9,1.6,1.4,1.8,2,1,1,2,0,2,WDWWLDWLLW,2025-07-27 14:09:22.547428
40,3,2023,Liverpool,10,5,5,7,4,3,0,0,0,3,1,2,29,17,12,2.9,3.4,2.4,12,5,7,1.2,1.0,1.4,3,2,1,1,1,0,WWWLWLWWLW,2025-07-27 14:09:22.547515
556,3,2023,Qarabag,14,7,7,7,3,4,3,2,1,4,2,2,24,10,14,1.7,1.4,2.0,22,9,13,1.6,1.3,1.9,3,1,2,1,1,0,WWWDWWLLDWWLDL,2025-07-27 14:09:22.547598
560,3,2023,Slavia Praha,12,6,6,7,5,2,1,0,1,4,1,3,27,18,9,2.3,3.0,1.5,14,3,11,1.2,0.5,1.8,6,5,1,1,0,1,WDWLWWLWWWLL,2025-07-27 14:09:22.547679
48,3,2023,West Ham,10,5,5,6,4,2,1,1,0,3,0,3,16,12,4,1.6,2.4,0.8,8,2,6,0.8,0.4,1.2,4,3,1,2,0,2,WWLWWWLWLD,2025-07-27 14:09:22.547759
562,3,2023,FC Astana,2,1,1,1,1,0,0,0,0,1,0,1,3,2,1,1.5,2.0,1.0,6,1,5,3.0,1.0,5.0,0,0,0,0,0,0,WL,2025-07-27 14:09:22.547843
51,3,2023,Brighton,8,4,4,5,3,2,1,0,1,2,1,1,11,6,5,1.4,1.5,1.3,9,3,6,1.1,0.8,1.5,5,3,2,1,0,1,LDWWWWLW,2025-07-27 14:09:22.547932
565,3,2023,BSC Young Boys,2,1,1,0,0,0,1,0,1,1,1,0,2,1,1,1.0,1.0,1.0,4,3,1,2.0,3.0,1.0,0,0,0,0,0,0,LD,2025-07-27 14:09:22.548013
566,3,2023,Ludogorets,4,2,2,2,1,1,0,0,0,2,1,1,8,6,2,2.0,3.0,1.0,7,5,2,1.8,2.5,1.0,1,0,1,0,0,0,LWLW,2025-07-27 14:09:22.548105
568,3,2023,Sheriff Tiraspol,10,5,5,2,2,0,3,1,2,5,2,3,15,11,4,1.5,2.2,0.8,22,8,14,2.2,1.6,2.8,0,0,0,2,0,2,WDDWLLDLLL,2025-07-27 14:09:22.548187
701,3,2023,KI Klaksvik,2,1,1,0,0,0,1,1,0,1,0,1,2,1,1,1.0,1.0,1.0,3,1,2,1.5,1.0,2.0,0,0,0,0,0,0,DL,2025-07-27 14:09:22.548266
575,3,2023,AEK Athens FC,6,3,3,1,0,1,1,1,0,4,2,2,6,1,5,1.0,0.3,1.7,12,4,8,2.0,1.3,2.7,0,0,0,2,2,0,WDLLLL,2025-07-27 14:09:22.548352
194,3,2023,Ajax,8,4,4,2,1,1,2,1,1,4,2,2,14,6,8,1.8,1.5,2.0,15,7,8,1.9,1.8,2.0,0,0,0,3,2,1,WLDDLLLW,2025-07-27 14:09:22.548434
329,3,2023,Molde,6,3,3,2,1,1,1,1,0,3,1,2,12,8,4,2.0,2.7,1.3,12,5,7,2.0,1.7,2.3,0,0,0,1,0,1,LLWWDL,2025-07-27 14:09:22.548514
586,3,2023,FK Zalgiris Vilnius,2,1,1,0,0,0,0,0,0,2,1,1,1,1,0,0.5,1.0,0.0,8,3,5,4.0,3.0,5.0,0,0,0,1,0,1,LL,2025-07-27 14:09:22.548594
588,3,2023,Zrinjski,4,2,2,1,1,0,1,1,0,2,0,2,8,7,1,2.0,3.5,0.5,6,3,3,1.5,1.5,1.5,0,0,0,1,0,1,WLLD,2025-07-27 14:09:22.548672
3408,3,2023,Aris,8,4,4,2,2,0,1,0,1,5,2,3,14,9,5,1.8,2.3,1.3,17,7,10,2.1,1.8,2.5,0,0,0,1,1,0,LWLWLLDL,2025-07-27 14:09:22.548761
81,3,2023,Marseille,14,7,7,6,5,1,4,2,2,4,0,4,27,18,9,1.9,2.6,1.3,22,8,14,1.6,1.1,2.0,3,2,1,2,0,2,DDWWWLDWWLLWDL,2025-07-27 14:09:22.548840
209,3,2023,Feyenoord,2,1,1,0,0,0,2,1,1,0,0,0,2,1,1,1.0,1.0,1.0,2,1,1,1.0,1.0,1.0,0,0,0,0,0,0,DD,2025-07-27 14:09:22.548922
211,3,2023,Benfica,6,3,3,3,2,1,2,1,1,1,0,1,7,6,1,1.2,2.0,0.3,5,4,1,0.8,1.3,0.3,2,0,2,2,0,2,WDDWWL,2025-07-27 14:09:22.549003
2646,3,2023,TSC Backa Topola,6,3,3,0,0,0,1,1,0,5,2,3,6,3,3,1.0,1.0,1.0,19,6,13,3.2,2.0,4.3,0,0,0,2,1,1,LDLLLL,2025-07-27 14:09:22.549081
599,3,2023,Zorya Luhansk,2,1,1,1,1,0,0,0,0,1,0,1,2,2,0,1.0,2.0,0.0,3,1,2,1.5,1.0,2.0,0,0,0,1,0,1,LW,2025-07-27 14:09:22.549168
217,3,2023,SC Braga,2,1,1,1,0,1,0,0,0,1,1,0,5,2,3,2.5,2.0,3.0,6,4,2,3.0,4.0,2.0,0,0,0,0,0,0,LW,2025-07-27 14:09:22.549245
606,3,2023,FC Lugano,2,1,1,0,0,0,0,0,0,2,1,1,0,0,0,0.0,0.0,0.0,3,1,2,1.5,1.0,2.0,0,0,0,2,1,1,LL,2025-07-27 14:09:22.549327
94,3,2023,Rennes,8,4,4,5,3,2,0,0,0,3,1,2,16,11,5,2.0,2.8,1.3,11,6,5,1.4,1.5,1.3,2,1,1,2,0,2,WLWWWLLW,2025-07-27 14:09:22.549407
2656,3,2023,Cukaricki,2,1,1,0,0,0,0,0,0,2,1,1,1,0,1,0.5,0.0,1.0,6,3,3,3.0,3.0,3.0,0,0,0,1,1,0,LL,2025-07-27 14:09:22.549487
96,3,2023,Toulouse,8,4,4,3,2,1,3,2,1,2,0,2,9,4,5,1.1,1.0,1.3,11,2,9,1.4,0.5,2.3,3,3,0,2,2,0,DWLWDWLD,2025-07-27 14:09:22.549577
4195,3,2023,Maccabi Haifa,6,3,3,1,0,1,2,1,1,3,2,1,3,1,2,0.5,0.3,0.7,9,5,4,1.5,1.7,1.3,2,1,1,4,2,2,LDLLDW,2025-07-27 14:09:22.549658
228,3,2023,Sporting CP,10,5,5,4,2,2,4,2,2,2,1,1,16,8,8,1.6,1.6,1.6,11,5,6,1.1,1.0,1.2,1,1,0,0,0,0,WLDWDWWDDL,2025-07-27 14:09:22.549738
742,3,2023,Genk,2,1,1,0,0,0,1,1,0,1,0,1,1,1,0,0.5,1.0,0.0,2,1,1,1.0,1.0,1.0,0,0,0,1,0,1,LD,2025-07-27 14:09:22.549819
617,3,2023,Panathinaikos,6,3,3,1,1,0,1,0,1,4,2,2,7,4,3,1.2,1.3,1.0,10,4,6,1.7,1.3,2.0,2,1,1,1,0,1,WDLLLL,2025-07-27 14:09:22.549903
489,3,2023,AC Milan,6,3,3,3,2,1,0,0,0,3,1,2,13,7,6,2.2,2.3,2.0,9,3,6,1.5,1.0,2.0,1,1,0,1,1,0,WLWWLL,2025-07-27 14:09:22.549983
620,3,2023,Dinamo Zagreb,2,1,1,1,1,0,0,0,0,1,0,1,4,3,1,2.0,3.0,1.0,5,1,4,2.5,1.0,4.0,0,0,0,0,0,0,WL,2025-07-27 14:09:22.550065
367,3,2023,BK Hacken,10,5,5,3,1,2,1,1,0,6,3,3,16,8,8,1.6,1.6,1.6,21,8,13,2.1,1.6,2.6,1,1,0,3,2,1,WWDWLLLLLL,2025-07-27 14:09:22.550144
1393,3,2023,Union St. Gilloise,8,4,4,4,3,1,2,1,1,2,0,2,8,7,1,1.0,1.8,0.3,8,3,5,1.0,0.8,1.3,3,1,2,3,0,3,WWDLWLDW,2025-07-27 14:09:22.550228
497,3,2023,AS Roma,14,7,7,7,5,2,4,1,3,3,1,2,23,16,7,1.6,2.3,1.0,12,4,8,0.9,0.6,1.1,5,4,1,3,1,2,WWWLDWDDWLWWLD,2025-07-27 14:09:22.550307
499,3,2023,Atalanta,13,7,6,8,5,3,4,1,3,1,1,0,25,12,13,1.9,1.7,2.2,8,3,5,0.6,0.4,0.8,6,4,2,1,1,0,WWDWDWDWWLDWW,2025-07-27 14:09:22.550387
628,3,2023,Sparta Praha,12,6,6,5,4,1,1,1,0,6,1,5,22,13,9,1.8,2.2,1.5,26,9,17,2.2,1.5,2.8,2,2,0,1,1,0,LWWLDLWWLWLL,2025-07-27 14:09:22.550470
116,3,2023,Lens,2,1,1,0,0,0,1,1,0,1,0,1,2,0,2,1.0,0.0,2.0,3,0,3,1.5,0.0,3.0,1,1,0,1,1,0,DL,2025-07-27 14:09:22.550552
252,3,2023,Aberdeen,2,1,1,0,0,0,1,0,1,1,1,0,3,1,2,1.5,1.0,2.0,5,3,2,2.5,3.0,2.0,0,0,0,0,0,0,DL,2025-07-27 14:09:22.550636
637,3,2023,Sturm Graz,6,3,3,1,0,1,1,1,0,4,2,2,4,3,1,0.7,1.0,0.3,9,5,4,1.5,1.7,1.3,1,0,1,3,1,2,LWDLLL,2025-07-27 14:09:22.550717
257,3,2024,Rangers,12,6,6,5,2,3,3,2,1,4,2,2,19,8,11,1.6,1.3,1.8,15,8,7,1.3,1.3,1.2,3,2,1,3,2,1,WLWDWDLWWLDL,2025-07-27 14:09:22.550800
1026,3,2024,Lask Linz,2,1,1,0,0,0,1,1,0,1,0,1,1,1,0,0.5,1.0,0.0,2,1,1,1.0,1.0,1.0,0,0,0,1,0,1,DL,2025-07-27 14:09:22.550890
645,3,2024,Galatasaray,10,5,5,3,3,0,5,2,3,2,0,2,22,15,7,2.2,3.0,1.4,22,11,11,2.2,2.2,2.2,0,0,0,0,0,0,WDWWDDDLLD,2025-07-27 14:09:22.550989
648,3,2024,Zira,2,1,1,1,0,1,0,0,0,1,1,0,2,1,1,1.0,1.0,1.0,2,2,0,1.0,2.0,0.0,1,0,1,0,0,0,WL,2025-07-27 14:09:22.551073
4360,3,2024,Celje,2,1,1,1,1,0,0,0,0,1,0,1,2,1,1,1.0,1.0,1.0,3,0,3,1.5,0.0,3.0,1,1,0,0,0,0,WL,2025-07-27 14:09:22.551167
394,3,2024,Dinamo Minsk,4,2,2,1,1,0,0,0,0,3,1,2,3,2,1,0.8,1.0,0.5,4,1,3,1.0,0.5,1.5,1,1,0,2,1,1,WLLL,2025-07-27 14:09:22.551253
2184,3,2024,Servette FC,2,1,1,0,0,0,1,0,1,1,1,0,1,1,0,0.5,1.0,0.0,2,2,0,1.0,2.0,0.0,1,0,1,1,0,1,DL,2025-07-27 14:09:22.551328
652,3,2024,Shamrock Rovers,4,2,2,1,1,0,0,0,0,3,1,2,3,3,0,0.8,1.5,0.0,8,3,5,2.0,1.5,2.5,0,0,0,3,1,2,LWLL,2025-07-27 14:09:22.551385
781,3,2024,Rapid Vienna,6,3,3,4,2,2,1,1,0,1,0,1,14,10,4,2.3,3.3,1.3,6,3,3,1.0,1.0,1.0,2,1,1,0,0,0,WWWWLD,2025-07-27 14:09:22.551441
651,3,2024,Ferencvarosi TC,12,6,6,5,4,1,2,1,1,5,1,4,17,11,6,1.4,1.8,1.0,19,6,13,1.6,1.0,2.2,4,3,1,4,1,3,DDLLWWWLLWWL,2025-07-27 14:09:22.551492
4495,3,2024,Maccabi Petah Tikva,2,1,1,0,0,0,0,0,0,2,1,1,0,0,0,0.0,0.0,0.0,7,5,2,3.5,5.0,2.0,0,0,0,2,1,1,LL,2025-07-27 14:09:22.551541
397,3,2024,FC Midtjylland,10,5,5,3,1,2,2,2,0,5,2,3,12,6,6,1.2,1.2,1.2,16,7,9,1.6,1.4,1.8,3,1,2,2,0,2,DWWLLLWDLL,2025-07-27 14:09:22.551594
531,3,2024,Athletic Club,14,7,7,8,6,2,2,0,2,4,1,3,22,14,8,1.6,2.0,1.1,17,5,12,1.2,0.7,1.7,6,4,2,2,1,1,DWWWWWLWLWDWLL,2025-07-27 14:09:22.551644
2073,3,2024,Silkeborg,2,1,1,1,1,0,0,0,0,1,0,1,4,3,1,2.0,3.0,1.0,5,2,3,2.5,2.0,3.0,0,0,0,0,0,0,LW,2025-07-27 14:09:22.551703
667,3,2024,Lincoln Red Imps FC,2,1,1,1,1,0,0,0,0,1,0,1,2,2,0,1.0,2.0,0.0,3,1,2,1.5,1.0,2.0,0,0,0,1,0,1,LW,2025-07-27 14:09:22.551788
415,3,2024,Twente,10,5,5,3,2,1,4,1,3,3,2,1,12,4,8,1.2,0.8,1.6,15,5,10,1.5,1.0,2.0,2,1,1,3,2,1,DDLDLDWWWL,2025-07-27 14:09:22.551878
33,3,2024,Manchester United,15,7,8,9,6,3,5,1,4,1,0,1,35,21,14,2.3,3.0,1.8,19,10,9,1.3,1.4,1.1,3,1,2,1,0,1,DDDWWWWWDWDWWWL,2025-07-27 14:09:22.551981
3874,3,2024,Panevėžys,2,1,1,0,0,0,0,0,0,2,1,1,1,1,0,0.5,1.0,0.0,5,2,3,2.5,2.0,3.0,0,0,0,1,0,1,LL,2025-07-27 14:09:22.552072
3364,3,2024,Borac Banja Luka,4,2,2,1,1,0,2,1,1,1,0,1,5,4,1,1.3,2.0,0.5,4,2,2,1.0,1.0,1.0,1,0,1,1,0,1,LWDD,2025-07-27 14:09:22.552167
549,3,2024,Besiktas,10,5,5,4,3,1,1,0,1,5,2,3,18,13,5,1.8,2.6,1.0,19,9,10,1.9,1.8,2.0,1,0,1,2,0,2,DWLLWWLLWL,2025-07-27 14:09:22.552243
548,3,2024,Real Sociedad,12,6,6,6,4,2,2,1,1,4,1,3,22,14,8,1.8,2.3,1.3,17,5,12,1.4,0.8,2.0,3,3,0,0,0,0,DLWLWWLWWWDL,2025-07-27 14:09:22.552332
167,3,2024,1899 Hoffenheim,8,4,4,2,1,1,3,2,1,3,1,2,11,6,5,1.4,1.5,1.3,14,5,9,1.8,1.3,2.3,2,2,0,3,1,2,DWLDLDLW,2025-07-27 14:09:22.552396
552,3,2024,Maribor,2,1,1,0,0,0,1,1,0,1,0,1,3,2,1,1.5,2.0,1.0,4,2,2,2.0,2.0,2.0,0,0,0,0,0,0,LD,2025-07-27 14:09:22.552467
553,3,2024,Olympiakos Piraeus,10,5,5,5,3,2,3,2,1,2,0,2,11,9,2,1.1,1.8,0.4,7,2,5,0.7,0.4,1.0,6,3,3,4,1,3,LWWDDDWWLW,2025-07-27 14:09:22.552521
554,3,2024,Anderlecht,12,6,6,6,3,3,3,2,1,3,1,2,18,12,6,1.5,2.0,1.0,17,9,8,1.4,1.5,1.3,3,2,1,2,0,2,WWWWWDDWLLLD,2025-07-27 14:09:22.552573
169,3,2024,Eintracht Frankfurt,12,6,6,7,4,3,2,1,1,3,1,2,21,11,10,1.8,1.8,1.7,14,5,9,1.2,0.8,1.5,3,3,0,2,1,1,DWWWWLWLWWDL,2025-07-27 14:09:22.552627
556,3,2024,Qarabag,8,4,4,1,0,1,0,0,0,7,4,3,6,4,2,0.8,1.0,0.5,20,12,8,2.5,3.0,2.0,0,0,0,4,1,3,LLLWLLLL,2025-07-27 14:09:22.552682
559,3,2024,FCSB,14,7,7,7,4,3,3,1,2,4,2,2,17,10,7,1.2,1.4,1.0,18,6,12,1.3,0.9,1.7,6,4,2,5,2,3,DWWWLWDDWLWWLL,2025-07-27 14:09:22.552733
560,3,2024,Slavia Praha,8,4,4,1,0,1,2,2,0,5,2,3,7,5,2,0.9,1.3,0.5,11,7,4,1.4,1.8,1.0,1,0,1,3,0,3,WDLLLLLD,2025-07-27 14:09:22.552788
561,3,2024,HNK Rijeka,4,2,2,1,1,0,2,1,1,1,0,1,2,2,0,0.5,1.0,0.0,3,1,2,0.8,0.5,1.0,2,1,1,2,0,2,DWDL,2025-07-27 14:09:22.552843
47,3,2024,Tottenham,15,8,7,10,6,4,3,2,1,2,0,2,28,17,11,1.9,2.1,1.6,13,5,8,0.9,0.6,1.1,6,4,2,1,0,1,WWWLDDWWLWDWWWW,2025-07-27 14:09:22.552894
566,3,2024,Ludogorets,10,5,5,2,1,1,4,1,3,4,3,1,10,7,3,1.0,1.4,0.6,12,8,4,1.2,1.6,0.8,3,1,2,5,2,3,WWLDLLDDLD,2025-07-27 14:09:22.552948
567,3,2024,Plzen,16,8,8,8,5,3,4,1,3,4,2,2,23,11,12,1.4,1.4,1.5,17,5,12,1.1,0.6,1.5,6,5,1,2,1,1,WWWWDDDWWLWLLWLD,2025-07-27 14:09:22.553004
568,3,2024,Sheriff Tiraspol,4,2,2,1,0,1,0,0,0,3,2,1,2,0,2,0.5,0.0,1.0,5,2,3,1.3,1.0,1.5,0,0,0,3,2,1,LWLL,2025-07-27 14:09:22.553073
14395,3,2024,Llapi,2,1,1,0,0,0,0,0,0,2,1,1,1,1,0,0.5,1.0,0.0,4,2,2,2.0,2.0,2.0,0,0,0,1,0,1,LL,2025-07-27 14:09:22.553132
572,3,2024,Dynamo Kyiv,8,4,4,1,1,0,1,0,1,6,3,3,5,2,3,0.6,0.5,0.8,18,9,9,2.3,2.3,2.3,1,1,0,5,2,3,LLLLLLDW,2025-07-27 14:09:22.553187
701,3,2024,KI Klaksvik,2,1,1,1,1,0,0,0,0,1,0,1,3,2,1,1.5,2.0,1.0,4,1,3,2.0,1.0,3.0,0,0,0,0,0,0,WL,2025-07-27 14:09:22.553250
702,3,2024,Vojvodina,2,1,1,0,0,0,0,0,0,2,1,1,1,1,0,0.5,1.0,0.0,4,3,1,2.0,3.0,1.0,0,0,0,1,0,1,LL,2025-07-27 14:09:22.553308
573,3,2024,FK Partizan,2,1,1,0,0,0,1,0,1,1,1,0,2,0,2,1.0,0.0,2.0,3,1,2,1.5,1.0,2.0,0,0,0,1,1,0,LD,2025-07-27 14:09:22.553373
703,3,2024,UE Santa Coloma,2,1,1,0,0,0,0,0,0,2,1,1,0,0,0,0.0,0.0,0.0,9,2,7,4.5,2.0,7.0,0,0,0,2,1,1,LL,2025-07-27 14:09:22.553446
4160,3,2024,Rīgas FS,12,6,6,4,3,1,2,2,0,6,1,5,18,13,5,1.5,2.2,0.8,16,6,10,1.3,1.0,1.7,3,2,1,3,1,2,WWWLLDLDLLWL,2025-07-27 14:09:22.553506
20034,3,2024,Corvinul Hunedoara,4,2,2,1,0,1,1,1,0,2,1,1,4,0,4,1.0,0.0,2.0,3,2,1,0.8,1.0,0.5,2,1,1,3,2,1,WLDL,2025-07-27 14:09:22.553561
194,3,2024,Ajax,18,9,9,10,5,5,1,0,1,7,4,3,33,18,15,1.8,2.0,1.7,19,9,10,1.1,1.0,1.1,7,4,3,3,1,2,WWWLWWWDWWLLLWWLLL,2025-07-27 14:09:22.553616
2247,3,2024,Apoel Nicosia,2,1,1,1,1,0,0,0,0,1,0,1,3,2,1,1.5,2.0,1.0,3,1,2,1.5,1.0,2.0,0,0,0,0,0,0,LW,2025-07-27 14:09:22.553679
327,3,2024,Bodo/Glimt,16,8,8,7,6,1,2,0,2,7,2,5,28,19,9,1.8,2.4,1.1,25,10,15,1.6,1.3,1.9,3,2,1,2,1,1,WDWLLWWDLWWLWLLL,2025-07-27 14:09:22.553737
329,3,2024,Molde,6,3,3,3,2,1,0,0,0,3,1,2,9,6,3,1.5,2.0,1.0,6,2,4,1.0,0.7,1.3,2,1,1,2,1,1,WLWLLW,2025-07-27 14:09:22.553792
201,3,2024,AZ Alkmaar,12,6,6,5,5,0,3,1,2,4,0,4,21,13,8,1.8,2.2,1.3,19,5,14,1.6,0.8,2.3,2,2,0,2,0,2,WLLWDDWLWDWL,2025-07-27 14:09:22.553847
3403,3,2024,Pafos,2,1,1,0,0,0,0,0,0,2,1,1,2,2,0,1.0,2.0,0.0,8,5,3,4.0,5.0,3.0,0,0,0,1,0,1,LL,2025-07-27 14:09:22.553904
336,3,2024,Jagiellonia,2,1,1,0,0,0,0,0,0,2,1,1,1,1,0,0.5,1.0,0.0,7,4,3,3.5,4.0,3.0,0,0,0,1,0,1,LL,2025-07-27 14:09:22.553972
80,3,2024,Lyon,12,6,6,6,3,3,4,2,2,2,1,1,29,12,17,2.4,2.0,2.8,16,6,10,1.3,1.0,1.7,3,2,1,2,1,1,WWLDWWDDWWDL,2025-07-27 14:09:22.554064
338,3,2024,Wisla Krakow,4,2,2,2,1,1,0,0,0,2,1,1,6,3,3,1.5,1.5,1.5,9,2,7,2.3,1.0,3.5,1,1,0,0,0,0,WWLL,2025-07-27 14:09:22.554148
2259,3,2024,FK Tobol Kostanay,2,1,1,1,1,0,0,0,0,1,0,1,3,1,2,1.5,1.0,2.0,5,0,5,2.5,0.0,5.0,1,1,0,0,0,0,LW,2025-07-27 14:09:22.554235
212,3,2024,FC Porto,10,5,5,3,2,1,3,2,1,4,1,3,16,8,8,1.6,1.6,1.6,15,5,10,1.5,1.0,2.0,3,2,1,1,1,0,LDWLDWLWDL,2025-07-27 14:09:22.554314
84,3,2024,Nice,8,4,4,0,0,0,3,3,0,5,1,4,7,5,2,0.9,1.3,0.5,16,8,8,2.0,2.0,2.0,0,0,0,2,0,2,DLLDLLLD,2025-07-27 14:09:22.554378
2390,3,2024,Paks,2,1,1,1,0,1,0,0,0,1,1,0,2,0,2,1.0,0.0,2.0,4,4,0,2.0,4.0,0.0,1,0,1,1,1,0,LW,2025-07-27 14:09:22.554430
2646,3,2024,TSC Backa Topola,2,1,1,0,0,0,0,0,0,2,1,1,1,1,0,0.5,1.0,0.0,8,5,3,4.0,5.0,3.0,0,0,0,1,0,1,LL,2025-07-27 14:09:22.554484
217,3,2024,SC Braga,14,7,7,7,5,2,3,1,2,4,1,3,22,11,11,1.6,1.6,1.6,16,4,12,1.1,0.6,1.7,5,4,1,3,1,2,WWDWWDWLLDWLLW,2025-07-27 14:09:22.554562
6489,3,2024,Kryvbas KR,2,1,1,0,0,0,0,0,0,2,1,1,1,1,0,0.5,1.0,0.0,3,2,1,1.5,2.0,1.0,0,0,0,1,0,1,LL,2025-07-27 14:09:22.554641
604,3,2024,Maccabi Tel Aviv,12,6,6,6,3,3,0,0,0,6,3,3,21,9,12,1.8,1.5,2.0,19,6,13,1.6,1.0,2.2,2,2,0,3,2,1,WWWWLLLLWWLL,2025-07-27 14:09:22.554724
3549,3,2024,Ružomberok,4,2,2,1,1,0,0,0,0,3,1,2,5,5,0,1.3,2.5,0.0,6,4,2,1.5,2.0,1.0,0,0,0,3,1,2,WLLL,2025-07-27 14:09:22.554805
606,3,2024,FC Lugano,4,2,2,1,0,1,2,2,0,1,0,1,7,5,2,1.8,2.5,1.0,10,5,5,2.5,2.5,2.5,1,0,1,0,0,0,WDDL,2025-07-27 14:09:22.554886
2271,3,2024,Petrocub,4,2,2,1,1,0,1,0,1,2,1,1,2,2,0,0.5,1.0,0.0,6,2,4,1.5,1.0,2.0,2,1,1,2,0,2,WDLL,2025-07-27 14:09:22.554980
354,3,2024,The New Saints,2,1,1,0,0,0,1,1,0,1,0,1,0,0,0,0.0,0.0,0.0,1,0,1,0.5,0.0,1.0,1,1,0,2,1,1,LD,2025-07-27 14:09:22.555048
611,3,2024,Fenerbahce,12,6,6,4,2,2,5,2,3,3,2,1,17,7,10,1.4,1.2,1.7,16,7,9,1.3,1.2,1.5,3,2,1,2,2,0,WDDLWLDDWDLW,2025-07-27 14:09:22.555110
741,3,2024,Cercle Brugge,4,2,2,2,2,0,1,0,1,1,0,1,3,2,1,0.8,1.0,0.5,4,0,4,1.0,0.0,2.0,2,2,0,1,0,1,DWLW,2025-07-27 14:09:22.555199
998,3,2024,Trabzonspor,4,2,2,2,1,1,0,0,0,2,1,1,3,1,2,0.8,0.5,1.0,3,1,2,0.8,0.5,1.0,2,1,1,2,1,1,WWLL,2025-07-27 14:09:22.555286
487,3,2024,Lazio,12,6,6,8,4,4,2,2,0,2,0,2,23,13,10,1.9,2.2,1.7,10,5,5,0.8,0.8,0.8,3,1,2,3,1,2,WWWWDWWLWDLW,2025-07-27 14:09:22.555381
617,3,2024,Panathinaikos,4,2,2,3,1,2,0,0,0,1,1,0,7,2,5,1.8,1.0,2.5,2,2,0,0.5,1.0,0.0,2,0,2,1,1,0,WWLW,2025-07-27 14:09:22.555448
250,3,2024,Kilmarnock,2,1,1,0,0,0,1,1,0,1,0,1,1,1,0,0.5,1.0,0.0,2,1,1,1.0,1.0,1.0,0,0,0,1,0,1,DL,2025-07-27 14:09:22.555507
619,3,2024,PAOK,12,6,6,5,3,2,1,1,0,6,2,4,19,14,5,1.6,2.3,0.8,14,5,9,1.2,0.8,1.5,5,3,2,4,1,3,WWLLDLWWWLLL,2025-07-27 14:09:22.555571
1393,3,2024,Union St. Gilloise,10,5,5,4,2,2,2,2,0,4,1,3,10,5,5,1.0,1.0,1.0,11,5,6,1.1,1.0,1.2,2,1,1,3,2,1,LDLDWWWLLW,2025-07-27 14:09:22.555660
497,3,2024,AS Roma,12,6,6,5,5,0,4,1,3,3,0,3,17,12,5,1.4,2.0,0.8,13,4,9,1.1,0.7,1.5,3,3,0,2,0,2,DLWDDWLWDWWL,2025-07-27 14:09:22.555745
372,3,2024,IF Elfsborg,16,8,8,9,6,3,2,1,1,5,1,4,24,11,13,1.5,1.4,1.6,18,2,16,1.1,0.3,2.0,8,6,2,3,1,2,WWWWDWWLLWLDLWWL,2025-07-27 14:09:22.555819
375,3,2024,Malmo FF,8,4,4,1,0,1,2,1,1,5,3,2,10,4,6,1.3,1.0,1.5,17,8,9,2.1,2.0,2.3,0,0,0,2,2,0,LWLLLDLD,2025-07-27 14:09:22.555880
634,3,2024,Botev Plovdiv,4,2,2,1,1,0,1,0,1,2,1,1,5,2,3,1.3,1.0,1.5,9,5,4,2.3,2.5,2.0,0,0,0,1,1,0,WDLL,2025-07-27 14:09:22.555950
254,3,2024,Heart Of Midlothian,2,1,1,0,0,0,0,0,0,2,1,1,0,0,0,0.0,0.0,0.0,2,1,1,1.0,1.0,1.0,0,0,0,2,1,1,LL,2025-07-27 14:09:22.556011
