team_id,league_id,season,team_name,matches_played_total,matches_played_home,matches_played_away,wins_total,wins_home,wins_away,draws_total,draws_home,draws_away,losses_total,losses_home,losses_away,goals_for_total,goals_for_home,goals_for_away,goals_for_avg_total,goals_for_avg_home,goals_for_avg_away,goals_against_total,goals_against_home,goals_against_away,goals_against_avg_total,goals_against_avg_home,goals_against_avg_away,clean_sheets_total,clean_sheets_home,clean_sheets_away,failed_to_score_total,failed_to_score_home,failed_to_score_away,form,extracted_at
810,94,2021,Vizela,34,17,17,7,4,3,12,7,5,15,6,9,37,16,21,1.1,0.9,1.2,58,21,37,1.7,1.2,2.2,2,1,1,11,6,5,LWLDDDDDLDDLWLLWLLWWDLLDLDDWLLWLDL,2025-07-27 14:09:22.466266
211,94,2021,Benfica,34,17,17,23,10,13,5,3,2,6,4,2,78,36,42,2.3,2.1,2.5,30,16,14,0.9,0.9,0.8,12,4,8,3,3,0,WWWWWWWLWDWWLWWLWDWLWWDWWDWLWWDWLW,2025-07-27 14:09:22.466344
212,94,2021,FC Porto,34,17,17,29,15,14,4,2,2,1,0,1,86,50,36,2.5,2.9,2.1,22,11,11,0.6,0.6,0.6,16,8,8,1,0,1,WWDWDWWWWWWWWWWWWWWWWDWDWWWWWWLWWW,2025-07-27 14:09:22.466424
214,94,2021,Maritimo,34,17,17,9,4,5,11,6,5,14,7,7,39,19,20,1.1,1.1,1.2,44,17,27,1.3,1.0,1.6,9,5,4,10,7,3,LWDLDDLDLLLWDWLWWWDLDWLDWLDLLWDLDL,2025-07-27 14:09:22.466503
215,94,2021,Moreirense,36,18,18,8,6,2,8,3,5,20,9,11,34,23,11,0.9,1.3,0.6,53,23,30,1.5,1.3,1.7,5,3,2,15,6,9,LDLDDLWDLDLDLLWLWDLLWLLDLLLLWWLLLWLW,2025-07-27 14:09:22.466581
216,94,2021,Portimonense,34,17,17,10,4,6,8,4,4,16,9,7,31,15,16,0.9,0.9,0.9,45,22,23,1.3,1.3,1.4,10,4,6,11,5,6,WLWLDWDWLLWWLWDLLDLLDDDDLLLLWLWLLW,2025-07-27 14:09:22.466659
217,94,2021,SC Braga,34,17,17,19,10,9,8,4,4,7,3,4,52,27,25,1.5,1.6,1.5,31,13,18,0.9,0.8,1.1,16,8,8,7,4,3,WLWDDWDDWWLWWLWWDLWWLWWDDLWWWDWWWL,2025-07-27 14:09:22.466743
218,94,2021,Tondela,34,17,17,7,4,3,7,4,3,20,9,11,41,24,17,1.2,1.4,1.0,67,33,34,2.0,1.9,2.0,2,1,1,10,4,6,WLLLLLWWLLWLLLLWDDLWLLLLDLDWLLDDLD,2025-07-27 14:09:22.466823
221,94,2021,Belenenses,34,17,17,5,5,0,11,3,8,18,9,9,23,15,8,0.7,0.9,0.5,55,30,25,1.6,1.8,1.5,8,4,4,17,6,11,LLLDDDDLDWLLLLLWLLDLLWLLDDDWLWDLLD,2025-07-27 14:09:22.466902
222,94,2021,Boavista,34,17,17,7,4,3,17,10,7,10,3,7,39,20,19,1.1,1.2,1.1,52,20,32,1.5,1.2,1.9,6,5,1,7,3,4,LWWDDLDDDLLLDLWDDDDLDDDWDDLWWLLWDD,2025-07-27 14:09:22.466993
223,94,2021,Chaves,2,1,1,1,1,0,0,0,0,1,0,1,2,2,0,1.0,2.0,0.0,1,0,1,0.5,0.0,1.0,1,1,0,1,0,1,WL,2025-07-27 14:09:22.467077
224,94,2021,Guimaraes,34,17,17,13,9,4,9,3,6,12,5,7,50,34,16,1.5,2.0,0.9,41,20,21,1.2,1.2,1.2,8,4,4,9,3,6,LDWDDDLWWLWLWWLDLDWLWLLLWWLWLWDDDW,2025-07-27 14:09:22.467165
227,94,2021,Santa Clara,34,17,17,9,8,1,13,6,7,12,3,9,38,24,14,1.1,1.4,0.8,54,23,31,1.6,1.4,1.8,8,5,3,10,4,6,LDLWLLDDLLLDWLWLWDWWDLDDWDDLWDDDWL,2025-07-27 14:09:22.467246
228,94,2021,Sporting CP,34,17,17,27,14,13,4,1,3,3,2,1,73,34,39,2.1,2.0,2.3,23,8,15,0.7,0.5,0.9,18,12,6,1,1,0,WWWDDWWWWWWWWWWWLWLWWDWDWWWWWLWWWW,2025-07-27 14:09:22.467329
230,94,2021,Estoril,34,17,17,9,4,5,12,8,4,13,5,8,36,21,15,1.1,1.2,0.9,43,21,22,1.3,1.2,1.3,11,6,5,11,4,7,WDWWWLDDWDDDLWDLLLLDDWLLDWLLLDDLWL,2025-07-27 14:09:22.467410
234,94,2021,Pacos Ferreira,34,17,17,9,5,4,11,6,5,14,6,8,29,19,10,0.9,1.1,0.6,44,22,22,1.3,1.3,1.3,10,4,6,13,5,8,WLLWDDDLDDLLLLWWLDDDDLWWLWWLWLDDLL,2025-07-27 14:09:22.467490
240,94,2021,Arouca,34,17,17,7,5,2,10,4,6,17,8,9,30,15,15,0.9,0.9,0.9,54,29,25,1.6,1.7,1.5,5,3,2,14,7,7,LLWLDDLLDWDWLLDLLLWDLLWDLLDWLDLWLD,2025-07-27 14:09:22.467571
242,94,2021,Famalicao,34,17,17,9,5,4,12,7,5,13,5,8,45,22,23,1.3,1.3,1.4,51,21,30,1.5,1.2,1.8,9,6,3,10,5,5,LLLDDDLLWDWLLLDDWDLDLWWWLDDLLDDWWW,2025-07-27 14:09:22.467654
762,94,2021,GIL Vicente,34,17,17,13,6,7,12,6,6,9,5,4,47,25,22,1.4,1.5,1.3,42,19,23,1.2,1.1,1.4,11,6,5,6,4,2,WWLLDDLDLWDDWWLWWDWWDWWDDWDLLDDLWL,2025-07-27 14:09:22.467738
